(supertux-level
  (version 3)
  (name (_ "Welcome To The Beach"))
  (author "Sophie Ball")
  (note (_ "World 3 Level 1, unfinished"))
  (license "CC-BY-SA 4.0 International")
  (allow-item-pocket "inherit")
  (icon "")
  (icon-locked "")
  (statistics
    (enable-coins #t)
    (enable-secrets #t)
  )
  (sector
    (name "main")
    (ambient-light
      (color 1 1 1)
    )
    (background
      (scroll-offset-y -200)
      (color 1 1 1)
      (speed 0.1)
      (image-top "/images/background/misc/transparent_up.png")
      (image "/images/background/beach/islands.png")
      (image-bottom "/images/background/beach/islands_bottom.png")
    )
    (background
      (color 1 1 1)
      (alignment "top")
      (scroll-speed-x -15)
      (speed 0)
      (image "/images/background/misc/light_clouds.png")
      (z-pos -399)
    )
    (bonusblock
      (type "purple")
      (z-pos 51)
      (x 3520)
      (y 1152)
    )
    (bonusblock
      (type "purple")
      (z-pos 51)
      (x 4320)
      (y 1184)
    )
    (camera
      (name "Camera")
      (mode "normal")
    )
    (dive-mine
      (z-pos 50)
      (x 7552)
      (y 2656)
      (glinting #f)
    )
    (dive-mine
      (z-pos 50)
      (x 7776)
      (y 2880)
      (glinting #f)
    )
    (dive-mine
      (z-pos 50)
      (x 7648)
      (y 3104)
      (glinting #f)
    )
    (fish-chasing
      (z-pos 50)
      (glinting #f)
      (x 2336)
      (y 2432)
    )
    (fish-chasing
      (z-pos 50)
      (glinting #f)
      (x 7616)
      (y 2752)
    )
    (fish-chasing
      (z-pos 50)
      (glinting #f)
      (x 5856)
      (y 2272)
    )
    (fish-harmless
      (z-pos 50)
      (x 2944)
      (y 1984)
    )
    (fish-harmless
      (z-pos 50)
      (x 2656)
      (y 2208)
    )
    (fish-harmless
      (z-pos 50)
      (x 2336)
      (y 2496)
    )
    (fish-harmless
      (z-pos 50)
      (x 3264)
      (y 2432)
    )
    (fish-harmless
      (z-pos 50)
      (x 3744)
      (y 2208)
    )
    (fish-harmless
      (z-pos 50)
      (x 3008)
      (y 2368)
    )
    (fish-harmless
      (z-pos 50)
      (x 5664)
      (y 1856)
    )
    (fish-harmless
      (z-pos 50)
      (x 5504)
      (y 2176)
    )
    (fish-harmless
      (z-pos 50)
      (x 5888)
      (y 2400)
    )
    (fish-harmless
      (z-pos 50)
      (x 5376)
      (y 2528)
    )
    (fish-harmless
      (z-pos 50)
      (x 6624)
      (y 2496)
    )
    (fish-harmless
      (z-pos 50)
      (x 7296)
      (y 2464)
    )
    (fish-harmless
      (z-pos 50)
      (x 7648)
      (y 3264)
    )
    (fish-harmless
      (z-pos 50)
      (x 8064)
      (y 3584)
    )
    (fish-swimming
      (z-pos 50)
      (glinting #f)
      (x 3136)
      (y 2272)
    )
    (fish-swimming
      (z-pos 50)
      (glinting #f)
      (x 3584)
      (y 2432)
    )
    (fish-swimming
      (z-pos 50)
      (glinting #f)
      (x 7712)
      (y 3008)
    )
    (fish-swimming
      (z-pos 50)
      (glinting #f)
      (x 5888)
      (y 2080)
    )
    (fish-swimming
      (z-pos 50)
      (glinting #f)
      (x 5504)
      (y 1984)
    )
    (fish-swimming
      (z-pos 50)
      (glinting #f)
      (x 5344)
      (y 2208)
    )
    (fish-swimming
      (z-pos 50)
      (glinting #f)
      (x 5632)
      (y 2432)
    )
    (goldbomb
      (z-pos 50)
      (x 6560)
      (y 1216)
      (glinting #t)
    )
    (gradient
      (top_color 0.5 0.7 1)
      (bottom_color 1 1 1)
      (z-pos -400)
    )
    (jumpy
      (type "wooden")
      (z-pos 50)
      (x 3360)
      (y 1248)
      (glinting #f)
    )
    (music
      (name "Music_Object")
      (file "/music/tropical/tropicalbreeze.music")
    )
    (path
      (name "gen17695205891768999748224")
      (path
        (adapt_speed #t)
        (node
          (x 9568)
          (y 1984)
          (time 3)
        )
        (node
          (x 10368)
          (y 1984)
          (time 3)
        )
      )
    )
    (platform
      (z-pos 50)
      (handle
        (scale_x 0)
        (scale_y 0)
        (offset_x 0)
        (offset_y 0)
      )
      (running #f)
      (name "p")
      (path-ref "gen17695205891768999748224")
    )
    (pushbutton
      (z-pos -99)
      (script "p.start_moving();")
      (x 5760)
      (y 1264)
    )
    (sequencetrigger
      (sequence "endsequence")
      (width 32)
      (height 1952)
      (x 11072)
      (y 0)
    )
    (smartball
      (z-pos 50)
      (x 6304)
      (y 1248)
      (glinting #f)
    )
    (smartball
      (z-pos 50)
      (x 4480)
      (y 1664)
      (glinting #f)
    )
    (smartball
      (z-pos 50)
      (x 3680)
      (y 1728)
      (glinting #f)
    )
    (smartblock
      (z-pos 50)
      (x 7264)
      (y 1184)
      (glinting #f)
    )
    (snowball
      (z-pos 50)
      (x 1152)
      (y 1600)
      (glinting #f)
    )
    (spawnpoint
      (name "main")
      (x 64)
      (y 1632)
    )
    (spawnpoint
      (x 6720)
      (y 2496)
    )
    (spawnpoint
      (x 5824)
      (y 1248)
    )
    (spawnpoint
      (x 10976)
      (y 1888)
    )
    (tilemap
      (solid #f)
      (z-pos -100)
      (name "MidGround_Tiles")
      (width 380)
      (height 120)
      (tiles -12750 0 402 403 404 405 -376 0 406 407 408 409 -376 0 410 411 426 427 404 405 -363 0 402 403 404 405 -7 0 414 415 430 431 408 409 402 403 404 405 -352 0 402 403 404 405 -3 0 406 407 408 409 -5 0 402 403 428 429 442 443 412 413 406 407 408 409 4495 4496 -3 0 402 403 404 405 -343 0 406 407 408 409 -3 0 410 411 412 413 -2 0 4492 -2 0 406 407 432 433 446 447 416 417 -274 0 4492 -75 0 402 403 404 405 -2 0 410 411 412 413 0 4495 4496 414 415 416 417 -282 0 4495 4496 -78 0 4492 406 407 408 409 -241 0 4499 4500 4501 4516 4517 -374 0 4502 4503 4504 4505 4518 4519 4520 -373 0 4506 4507 4508 4509 4521 4522 4523 -367 0 402 403 404 405 -4 0 4510 4511 -345 0 4499 4500 4501 4516 4517 -20 0 406 407 408 409 -5 0 4512 -91 0 4497 4498 -251 0 4502 4503 4504 4505 4518 4519 4520 -19 0 410 411 412 413 -5 0 4513 -43 0 402 403 404 405 -297 0 4506 4507 4508 4509 4521 4522 4523 -19 0 414 415 416 417 -5 0 4513 -43 0 406 407 408 409 -61 0 402 403 404 405 -234 0 4510 4511 -31 0 4513 -43 0 410 411 426 427 404 405 -54 0 4492 0 4495 4496 0 406 407 408 409 4492 -220 0 402 403 404 405 -10 0 4512 -31 0 4514 402 403 404 405 -39 0 414 415 430 431 408 409 -39 0 402 403 404 405 -241 0 406 407 408 409 -10 0 4513 -8 0 4495 4496 0 4492 -3 0 4497 4498 -14 0 4515 406 407 408 409 4495 4496 -8 0 4497 4498 -29 0 410 411 426 427 404 405 -37 0 406 407 408 409 -234 0 404 405 -5 0 410 411 412 413 -10 0 4514 -55 0 4495 4496 -20 0 414 415 430 431 408 409 -37 0 410 411 412 413 -234 0 408 409 -3 0 4495 4496 414 415 416 417 0 4497 4498 -3 0 4492 -3 0 4515 -79 0 410 411 426 427 404 405 -31 0 4497 4498 4495 4496 414 415 416 417 0 4497 4498 -99 0 4497 4498 -231 0 414 415 430 431 408 409 -238 0 130 -137 0 410 411 412 413 4497 4498 -3 0 4495 4496 -14 0 4492 -127 0 4495 4496 -87 0 129 -379 0 129 -22 0 402 403 404 405 -353 0 129 -22 0 406 407 408 409 -293 0 402 403 404 405 -42 0 402 403 404 405 -10 0 129 -20 0 402 403 428 429 412 413 -289 0 4492 0 4495 4496 406 407 408 409 4497 4498 0 4492 -38 0 406 407 408 409 -10 0 129 -20 0 406 407 432 433 416 417 -339 0 410 411 426 427 404 405 -8 0 129 -8 0 402 403 404 405 -8 0 410 411 444 445 426 427 404 405 -337 0 414 415 430 431 408 409 4495 4496 -6 0 129 -4 0 4497 4498 -2 0 406 407 408 409 -3 0 4495 4496 -3 0 414 415 448 449 430 431 408 409 -2 0 4497 4498 -6679 0 4492 -2 0 4497 4498 -5 0 4495 4496 0 4492 -645 0 4495 4496 0 4492 -464 0 4495 4496 -2 0 4497 4498 -266 0 4492 -3 0 4497 4498 -95 0 4492 -267 0 4495 4496 -364 0 4495 4496 -4 0 4492 -101 0 4492 -3 0 4495 4496 -359 0 4495 4496 -2 0 4492 -2 0 4497 4498 -10735 0 4492 -734 0 4492 0 4495 4496 -4 0 4497 4498 -3 0 4492 0 4495 4496 -1640 0)
    )
    (tilemap
      (solid #f)
      (z-pos -150)
      (name "BackGround_Tiles")
      (width 380)
      (height 120)
      (tiles -9702 0 4499 4500 4501 4516 4517 -374 0 4502 4503 4504 4505 4518 4519 4520 -373 0 4506 4507 4508 4509 4521 4522 4523 -15 0 4499 4500 4501 4516 4517 -355 0 4510 4511 -17 0 4502 4503 4504 4505 4518 4519 4520 -336 0 4499 4500 4501 4516 4517 -14 0 4512 -17 0 4506 4507 4508 4509 4521 4522 4523 -335 0 4502 4503 4504 4505 4518 4519 4520 -13 0 4513 -19 0 4510 4511 -338 0 4506 4507 4508 4509 4521 4522 4523 -13 0 4513 -20 0 4512 -340 0 4510 4511 -16 0 4513 -20 0 4513 -290 0 4499 4500 4501 4516 4517 -46 0 4512 -16 0 4513 -20 0 4513 -289 0 4502 4503 4504 4505 4518 4519 4520 -45 0 4513 -16 0 4513 -20 0 4513 -289 0 4506 4507 4508 4509 4521 4522 4523 -45 0 4513 -16 0 4513 -20 0 4513 -291 0 4510 4511 -48 0 4513 -16 0 4513 -20 0 4514 -292 0 4512 -48 0 4513 -16 0 4514 -20 0 4515 -292 0 4513 -26 0 4499 4500 4501 4516 4517 -17 0 4513 -16 0 4515 -313 0 4513 -15 0 4499 4500 4501 4516 4517 -5 0 4502 4503 4504 4505 4518 4519 4520 -16 0 4514 -225 0 4499 4500 4501 4516 4517 -35 0 4499 4500 4501 4516 4517 -60 0 4514 -14 0 4502 4503 4504 4505 4518 4519 4520 -4 0 4506 4507 4508 4509 4521 4522 4523 -16 0 4515 -224 0 4502 4503 4504 4505 4518 4519 4520 -33 0 4502 4503 4504 4505 4518 4519 4520 -59 0 4515 -14 0 4506 4507 4508 4509 4521 4522 4523 -6 0 4510 4511 -244 0 4506 4507 4508 4509 4521 4522 4523 -33 0 4506 4507 4508 4509 4521 4522 4523 -76 0 4510 4511 -10 0 4512 -246 0 4510 4511 -38 0 4510 4511 -80 0 4512 -10 0 4513 -247 0 4512 -39 0 4512 -80 0 4513 -10 0 4513 -247 0 4513 -39 0 4513 -80 0 4513 -10 0 4513 -88 0 4499 4500 4501 4516 4517 -154 0 4513 -39 0 4513 -80 0 4513 -10 0 4513 -87 0 4502 4503 4504 4505 4518 4519 4520 -153 0 4513 -39 0 4513 -80 0 4514 -10 0 4514 -87 0 4506 4507 4508 4509 4521 4522 4523 -115 0 4499 4500 4501 -35 0 4513 -39 0 4513 -80 0 4515 -10 0 4515 -89 0 4510 4511 -117 0 4502 4503 4504 4505 -35 0 4514 -39 0 4513 -182 0 4512 -32 0 4499 4500 4501 4516 4517 -57 0 4499 4500 4501 4516 4517 -18 0 4506 4507 4508 4509 -35 0 4515 -39 0 4514 -182 0 4513 -31 0 4502 4503 4504 4505 4518 4519 4520 -55 0 4502 4503 4504 4505 4518 4519 4520 -6 0 4499 4500 4501 4516 4517 -8 0 4510 4511 -75 0 4515 -182 0 4513 -20 0 4499 4500 4501 4516 4517 -6 0 4506 4507 4508 4509 4521 4522 4523 -42 0 4499 4500 4501 4516 4517 -8 0 4506 4507 4508 4509 4521 4522 4523 -5 0 4502 4503 4504 4505 4518 4519 4520 -8 0 4512 -258 0 4513 -19 0 4502 4503 4504 4505 4518 4519 4520 -7 0 4510 4511 -44 0 4502 4503 4504 4505 4518 4519 4520 -9 0 4510 4511 -8 0 4506 4507 4508 4509 4521 4522 4523 -8 0 4513 -258 0 4514 -19 0 4506 4507 4508 4509 4521 4522 4523 -8 0 4512 -44 0 4506 4507 4508 4509 4521 4522 4523 -10 0 4512 -10 0 4510 4511 -11 0 4513 -258 0 4515 -21 0 4510 4511 -11 0 4513 -46 0 4510 4511 -13 0 4513 -11 0 4512 -11 0 4513 -281 0 4512 -11 0 4513 -47 0 4512 -13 0 4513 -11 0 4513 -11 0 4513 -281 0 4513 -11 0 4513 -47 0 4513 -13 0 4513 -11 0 4513 -11 0 4513 -281 0 4514 -11 0 4514 -47 0 4513 -13 0 4513 -11 0 4513 -11 0 4513 -281 0 4515 -11 0 4515 -47 0 4513 -13 0 4513 -11 0 4513 -11 0 4513 -341 0 4514 -13 0 4514 -11 0 4514 -11 0 4514 -341 0 4515 -13 0 4515 -11 0 4515 -11 0 4515 -22420 0)
    )
    (tilemap
      (solid #t)
      (z-pos 0)
      (name "Main_Tiles")
      (width 380)
      (height 120)
      (tiles -111 0 4336 -22 4337 4338 -356 0 4336 -22 4337 4338 -356 0 4336 -22 4337 4338 -356 0 4336 -22 4337 4338 -356 0 4336 -22 4337 4338 -356 0 4336 -22 4337 4338 -356 0 4336 -22 4337 4338 -356 0 4336 -22 4337 4338 -356 0 4336 -22 4337 4338 -356 0 4336 -22 4337 4338 -356 0 4336 -22 4337 4338 -356 0 4336 -22 4337 4338 -356 0 4336 -22 4337 4338 -356 0 4336 -22 4337 4338 -356 0 4336 -22 4337 4338 -356 0 4336 -22 4337 4338 -356 0 4336 -22 4337 4338 -356 0 4336 -22 4337 4338 -356 0 4336 -22 4337 4338 -356 0 4336 -22 4337 4338 -356 0 4336 -22 4337 4338 -356 0 4336 -22 4337 4338 -356 0 4336 -22 4337 4338 -356 0 4336 -22 4337 4338 -356 0 4336 -22 4337 4338 -356 0 4336 -22 4337 4338 -356 0 4336 -22 4337 4338 -356 0 4336 -22 4337 4338 -356 0 4336 -22 4337 4338 -356 0 4336 -22 4337 4338 -356 0 4336 -22 4337 4338 -356 0 4336 -22 4337 4338 -356 0 4336 -22 4337 4338 -356 0 4336 -22 4337 4338 -356 0 4336 -22 4337 4338 -356 0 4336 -22 4337 4338 -356 0 4336 -22 4337 4338 -356 0 4336 -22 4337 4338 -356 0 4336 -22 4337 4338 -77 0 4437 4438 4439 4440 -12 4333 4430 4431 4470 -260 0 4336 -22 4337 4338 -65 0 4437 4438 4439 4440 -8 4333 4441 4442 4443 -14 4337 4434 4471 4472 -255 0 4437 4438 4439 4440 4361 -22 4337 4338 -43 0 4454 4439 4427 4431 4432 4433 -5 0 4437 4438 4439 4440 -7 4333 4441 4442 4443 -28 4337 4473 4419 -251 0 4332 -2 4333 4441 4442 4443 -24 4337 4360 4430 4431 4432 4433 -39 0 4458 4443 4337 4434 4435 4436 -5 4333 4441 4442 4443 -40 4337 4423 4419 -236 0 4478 4439 4427 4431 4470 -9 0 4340 -6 4341 4357 -24 4337 4434 4435 4436 4334 -38 0 4405 -54 4337 4423 4419 -209 0 -3 83 -22 0 4479 4480 4443 4337 4434 4471 4472 -15 0 4405 -22 4337 4356 -4 4341 4342 -38 0 4407 -55 4337 4423 4419 -232 0 4462 4482 -5 4337 4473 4419 -14 0 4407 -22 4337 4406 -43 0 4409 4389 -55 4337 4423 4419 4488 -230 0 4466 -7 4337 4423 4419 -13 0 4409 4387 -21 4337 4408 -44 0 4393 -56 4337 4423 4474 4489 -197 0 -2 44 -26 0 44 -3 0 4405 -8 4337 4423 4419 -13 0 4391 4379 4380 -18 4337 4388 4410 -9 0 4344 -3 4345 4346 -30 0 4395 4389 -56 4337 4475 4476 4470 -172 0 -5 83 -7 0 4478 4439 4427 4431 4470 -6 0 44 -2 0 44 -4 0 4344 -3 4345 4346 -15 0 44 0 44 -2 0 4407 -9 4337 4423 4421 -13 0 4383 4384 4379 4380 -14 4337 4381 4382 4392 -46 0 4393 -57 4337 4477 4471 4472 4488 -145 0 -2 44 -7 0 -2 44 -24 0 4486 4479 4480 4443 4337 4434 4471 4472 4488 -31 0 44 -3 0 44 0 4409 4389 -9 4337 4425 -15 0 4383 4384 -14 4341 4385 4386 -47 0 4395 4387 -58 4337 4473 4474 4489 -143 0 44 -2 0 44 -5 0 44 -2 0 44 -22 0 4487 4481 4482 -5 4337 4473 4474 4489 -34 0 44 -2 0 4393 -9 4337 4428 4421 -54 0 4332 -13 4333 4334 -11 0 4391 4387 -58 4337 4475 4476 4470 -175 0 4437 4438 4483 4484 -7 4337 4475 4476 4432 4433 -33 0 44 0 4395 4387 -9 4337 4425 -54 0 4336 -13 4337 4406 -12 0 4391 4387 -58 4337 4477 4471 4472 4488 -160 0 4437 4438 4439 4440 -9 4333 4441 4442 4485 -9 4337 4477 4435 4436 -17 4333 4430 4431 4432 4433 -12 0 44 -2 0 4391 4389 -8 4337 4428 4419 -5 0 -3 77 -3 0 77 104 77 -39 0 4336 -13 4337 4408 -13 0 4391 4387 -59 4337 4473 4474 4489 -155 0 4437 4438 4439 4440 4441 4442 4443 -43 4337 4434 4435 4436 -5 4333 4430 4431 4455 -4 0 44 -3 0 4393 -9 4337 4423 4419 4488 -51 0 4336 -12 4337 4388 4410 -14 0 4391 4379 4380 -58 4337 4475 4476 4432 4433 -131 0 -22 4333 4441 4442 4443 -56 4337 4434 4459 -8 0 4395 4387 -9 4337 4423 4474 4489 -29 0 4437 4438 4439 4440 -11 4333 4334 -5 3458 4336 -11 4337 4388 4392 -16 0 4383 4384 4387 -58 4337 4477 4435 4436 4430 4431 4432 4433 -127 0 -82 4337 4406 -9 0 4391 4387 -9 4337 4475 4476 4432 4433 -23 0 4437 4438 4439 4440 4441 4442 4443 -12 4337 4360 -5 4333 4361 -10 4337 4390 4392 -12 0 44 -6 0 4391 4387 -61 4337 4434 4435 4436 4430 4431 4432 4433 -123 0 -82 4337 4408 -10 0 4391 4387 -9 4337 4477 4435 4436 -9 4333 4430 4431 4455 -4 0 4454 4439 4440 -4 4333 4441 4442 4443 -33 4337 4394 -21 0 4391 4387 -64 4337 4434 4435 4436 -2 4333 4430 4431 4470 -23 0 -2 83 102 -2 83 -90 0 -81 4337 4388 4410 -11 0 4391 4389 -21 4337 4434 4459 -4 0 4458 4443 -40 4337 4390 4396 -22 0 4391 4387 -69 4337 4434 4471 4472 -117 0 -80 4337 4390 4392 -13 0 4393 -22 4337 4406 -4 0 4405 -41 4337 4394 -24 0 4391 4387 -70 4337 4473 4419 -71 0 -5 83 -40 0 -80 4337 4394 -14 0 4395 4389 -21 4337 4408 -4 0 4407 -40 4337 4390 4396 -25 0 4391 4387 -70 4337 4423 4419 -17 0 44 -2 0 44 0 44 0 44 -2 0 44 -87 0 -79 4337 4390 4396 -15 0 4393 -20 4337 4390 4410 -4 0 4409 4389 -39 4337 4394 -27 0 4391 4389 -70 4337 4423 4421 -12 0 4478 4439 4440 -13 4333 4430 4431 4470 -83 0 -79 4337 4394 -16 0 4395 4387 -19 4337 4394 -6 0 4393 -38 4337 4390 4396 -28 0 4393 -71 4337 4425 -11 0 4479 4480 4443 -15 4337 4434 4471 4472 -82 0 -78 4337 4390 4396 -17 0 4391 4379 4380 -16 4337 4388 4396 -2 0 44 -3 0 4395 4389 -37 4337 4394 -29 0 4395 4389 -70 4337 4428 4421 -9 0 4462 4482 -19 4337 4473 4463 -29 0 4454 4439 4440 -49 4333 -78 4337 4394 -19 0 4383 4384 4379 4380 -12 4337 4381 4382 4392 -8 0 4393 -36 4337 4388 4396 -30 0 4393 -71 4337 4465 -9 0 4466 -21 4337 4467 -29 0 4458 4443 -127 4337 4388 4396 -21 0 4383 4384 4379 4380 -8 4337 4381 4382 4385 4386 -9 0 4395 4357 -33 4337 4381 4382 4392 -7 0 44 -23 0 4395 4389 -70 4337 4469 -9 0 4405 -21 4337 4338 -29 0 4336 -126 4337 4381 4382 4392 -24 0 4383 4384 -8 4341 4385 4386 -12 0 4336 -32 4337 4388 4385 4386 -33 0 4393 -70 4337 4338 -9 0 4407 -21 4337 4338 -29 0 4336 -124 4337 4381 4382 4385 4386 -49 0 4336 -31 4337 4390 4392 -35 0 4395 4389 -69 4337 4338 -9 0 4409 4357 -20 4337 4338 -29 0 4336 -122 4337 4381 4382 4385 4386 -10 0 44 -40 0 4336 -31 4337 4394 -37 0 4393 -69 4337 4338 -10 0 4336 -20 4337 4338 -29 0 4336 -120 4337 4381 4382 4385 4386 -43 0 44 -4 0 44 -4 0 4336 -30 4337 4390 4396 -37 0 4395 4387 -68 4337 4338 -10 0 4336 -20 4337 4338 -29 0 4336 -119 4337 4388 4385 4386 -55 0 4336 -30 4337 4394 -39 0 4391 4387 -67 4337 4338 -10 0 4336 -20 4337 4338 -29 3458 4336 -118 4337 4388 4392 -57 0 4336 -29 4337 4356 4396 -22 0 44 -17 0 4391 4387 -66 4337 4338 -10 0 4336 -20 4337 4360 -29 4333 4361 -117 4337 4390 4392 -58 0 4336 -29 4337 4338 -42 0 4391 4387 -65 4337 4360 4421 -9 0 4336 -168 4337 4394 -27 0 44 -18 0 44 -12 0 4336 -29 4337 4338 -43 0 4391 4387 -65 4337 4465 -9 0 4405 -167 4337 4390 4396 -59 0 4336 -29 4337 4338 -44 0 4391 4379 4380 -63 4337 4469 -9 0 4407 -167 4337 4394 -7 0 44 -52 0 4336 -29 4337 4338 -37 0 44 -7 0 4383 4384 4379 4380 -61 4337 4338 -9 0 4409 4357 -165 4337 4356 4396 -60 0 4336 -29 4337 4338 -3 0 44 -43 0 4383 4384 4379 4380 -59 4337 4338 -10 0 4336 -165 4337 4338 -61 0 4336 -29 4337 4338 -49 0 4383 4384 -34 4341 4379 4380 -23 4337 4338 -10 0 4336 -165 4337 4338 -36 0 44 -23 0 4422 4361 -29 4337 4338 -62 0 44 -7 0 44 -14 0 4383 4384 4387 -22 4337 4338 -10 0 4336 -165 4337 4338 -18 0 44 -41 0 4426 -30 4337 4338 -16 0 44 -32 0 44 -10 0 44 -3 0 44 -3 0 44 -3 0 44 -14 0 4391 4389 -21 4337 4338 -10 0 4336 -165 4337 4338 -58 0 4486 4420 4429 -30 4337 4338 -66 0 44 -7 0 44 -13 0 4393 -21 4337 4338 -10 0 4336 -165 4337 4338 -4 0 44 -52 0 4487 4481 4424 -31 4337 4338 -57 0 4454 4439 4440 -16 4333 4334 -11 0 4395 4357 -20 4337 4360 4421 -9 0 4405 -165 4337 4360 4421 -54 0 4437 4438 4483 4484 -32 4337 4338 -29 0 44 -12 0 44 -14 0 4458 4443 -17 4337 4338 -12 0 4336 -21 4337 4465 -9 0 4407 -166 4337 4425 -44 0 4437 4438 4439 4440 -6 4333 4441 4442 4485 -33 4337 4360 4421 -52 0 4437 4438 4439 4440 4361 -18 4337 4338 -12 0 4336 -21 4337 4469 -9 0 4409 4357 -165 4337 4428 4419 4488 -38 0 4437 4438 4439 4440 4441 4442 4443 -44 4337 4425 -41 0 4437 4438 4439 4440 -7 4333 4441 4442 4443 -20 4337 4338 -12 0 4336 -21 4337 4338 -10 0 4336 -166 4337 4423 4474 4489 -21 0 4437 4438 4439 4440 -12 4333 4441 4442 4443 -48 4337 4428 4419 4488 -6 0 44 -22 0 4437 4438 4439 4440 -6 4333 4441 4442 4443 -31 4337 4338 -12 0 4336 -21 4337 4338 -10 0 4336 -167 4337 4475 4476 4432 4433 -8 0 4437 4438 4439 4440 -7 4333 4441 4442 4443 -65 4337 4423 4474 4489 -24 0 4437 4438 4439 4440 4441 4442 4443 -41 4337 4338 -12 0 4336 -21 4337 4338 -10 0 4336 -168 4337 4477 4435 4436 -8 4333 4441 4442 4443 -77 4337 4475 4476 4432 4433 -12 0 4437 4438 4439 4440 -6 4333 4441 4442 4443 -45 4337 4338 -12 0 4336 -21 4337 4338 -10 0 4336 -260 4337 4477 4435 4436 -12 4333 4441 4442 4443 -55 4337 4338 -12 0 4336 -21 4337 4338 -10 0 4336 -333 4337 4338 -12 0 4336 -21 4337 4338 -10 0 4405 -333 4337 4338 -12 0 4336 -21 4337 4360 4421 -9 0 4407 -333 4337 4338 -12 0 4336 -22 4337 4465 -9 0 4409 4357 -332 4337 4338 -12 0 4336 -22 4337 4469 -10 0 4405 -332 4337 4338 -12 0 4336 -22 4337 4338 -10 0 4407 -332 4337 4338 -12 0 4336 -22 4337 4338 -10 0 4409 4357 -331 4337 4338 -12 0 4336 -22 4337 4338 -11 0 4405 -331 4337 4338 -12 0 4336 -22 4337 4338 -11 0 4407 -331 4337 4338 -12 0 4336 -22 4337 4338 -11 0 4409 4357 -330 4337 4338 -12 0 4336 -22 4337 4338 -12 0 4336 -330 4337 4338 -12 0 4336 -22 4337 4338 -12 0 4336 -330 4337 4338 -12 0 4336 -22 4337 4338 -12 0 4336 -330 4337 4338 -12 0 4336 -22 4337 4338 -12 0 4336 -330 4337 4338 -12 0 4336 -22 4337 4338 -12 0 4336 -330 4337 4338 -12 0 4336 -22 4337 4406 -12 0 4336 -330 4337 4338 -12 0 4336 -22 4337 4408 -11 0 4422 4361 -330 4337 4338 -12 0 4336 -21 4337 4390 4410 -11 0 4426 -331 4337 4338 -12 0 4336 -21 4337 4394 -11 0 4422 4429 -331 4337 4338 -12 0 4405 -20 4337 4388 4396 -10 0 4486 4426 -332 4337 4360 4421 -11 0 4407 -19 4337 4388 4392 -10 0 4487 4481 4429 -333 4337 4425 -11 0 4409 4387 -16 4337 4381 4382 4392 -10 0 4478 4483 4484 -334 4337 4428 4421 -11 0 4391 4379 4380 -12 4337 4381 4382 4385 4386 -9 0 4486 4479 4480 4485 -336 4337 4425 -12 0 4383 4384 -12 4341 4385 4386 -10 0 4487 4481 4482 -338 4337 4428 4419 -36 0 4478 4483 4484 -340 4337 4423 4419 -33 0 4486 4479 4480 4485 -342 4337 4423 4419 -14 0 44 0 44 0 44 -12 0 4487 4481 4482 -345 4337 4423 4419 4488 -13 0 44 0 44 0 44 -9 0 4437 4438 4483 4484 -347 4337 4423 4474 4489 -22 0 4437 4438 4439 4440 4441 4442 4485 -349 4337 4475 4476 4432 4433 -16 0 4437 4438 4439 4440 4441 4442 4443 -354 4337 4477 4435 4436 -16 4333 4441 4442 4443 -1257 4337)
    )
    (tilemap
      (solid #f)
      (tint 0.5 0.5 0.5)
      (z-pos -101)
      (width 380)
      (height 120)
      (tiles -16064 0 4332 -34 4333 4334 -344 0 4336 -34 4337 4338 -344 0 4336 -34 4337 4338 -344 0 4336 -34 4337 4338 -344 0 4336 -34 4337 4338 -4 0 4332 -3 4333 4334 -294 0 4332 -3 4333 4334 -35 0 4422 4361 -34 4337 4338 -4 0 4336 -3 4337 4338 -294 0 4336 -3 4337 4338 -35 0 4464 -35 4337 4338 -4 0 4336 -3 4337 4338 -33 0 4422 -3 4337 -257 0 4336 -3 4337 4338 -35 0 4468 -35 4337 4360 4421 -3 0 4336 -3 4337 4338 -33 0 4426 -3 4337 -257 0 4336 -3 4337 4338 -34 0 4422 4361 -36 4337 4465 -3 0 4336 -3 4337 4338 -19 0 4337 4411 4412 -10 0 4420 4429 -3 4337 -257 0 4336 -3 4337 4338 -34 0 4464 -37 4337 4469 -3 0 4336 -3 4337 4338 -19 0 4337 4415 4416 4411 4412 -6 0 4413 4414 4424 -4 4337 -296 0 4468 -37 4337 4360 4421 -2 0 4336 -3 4337 4338 -16 0 -6 4337 4415 4416 -6 4333 4417 4418 -7 4337 -294 0 4361 -38 4337 4425 -2 0 4336 -3 4337 4338 -14 0 -27 4337 -292 0 -39 4337 4428 -20 0 -31 4337 -268 0 4333 4419 -19 0 -35 4337 -24 0 -33 4337 -266 0 -2 4337 4423 4411 4412 -8 0 4413 4414 -2 4333 -7 0 4336 -31 4337 -24 0 -36 4337 -263 0 -2 4333 -2 4337 4415 4416 -8 4333 4417 4418 -2 4337 4333 -6 0 4336 -30 4337 -24 0 -39 4337 -257 0 -60 4337 -23 0 -41 4337 -253 0 -63 4337 -23 0 -42 4337 -251 0 -63 4337 -23 0 -44 4337 -247 0 -66 4337 -23 0 -46 4337 -243 0 -68 4337 -22 0 -48 4337 -240 0 -70 4337 -22 0 -49 4337 -237 0 -72 4337 -21 0 -51 4337 -73 0 4422 -3 4337 -158 0 -73 4337 -21 0 -52 4337 -72 0 4426 -3 4337 -157 0 -74 4337 -20 0 -54 4337 -58 0 4411 4412 -10 0 4420 4429 -3 4337 -156 0 -75 4337 -20 0 -57 4337 -55 0 4415 4416 4411 4412 -6 0 4413 4414 4424 -4 4337 -155 0 -76 4337 -19 0 -61 4337 -52 0 -2 4337 4415 4416 -6 4333 4417 4418 -5 4337 -154 0 -77 4337 -19 0 -63 4337 -50 0 -17 4337 -154 0 -77 4337 -19 0 -70 4337 -42 0 -18 4337 -154 0 -77 4337 -19 0 -75 4337 -37 0 -18 4337 -154 0 -77 4337 -19 0 -93 4337 -19 0 -18 4337 -154 0 -77 4337 -19 0 -95 4337 -17 0 -18 4337 -154 0 -77 4337 -19 0 -96 4337 -16 0 -18 4337 -154 0 -77 4337 -19 0 -97 4337 -15 0 -18 4337 -154 0 -77 4337 -19 0 -97 4337 -15 0 -18 4337 -154 0 -77 4337 -19 0 -97 4337 -15 0 -18 4337 -154 0 -77 4337 -19 0 -97 4337 -15 0 -18 4337 -154 0 -77 4337 -19 0 -98 4337 -14 0 -18 4337 -154 0 -77 4337 -19 0 -98 4337 -14 0 -18 4337 -155 0 -76 4337 -19 0 -98 4337 -14 0 -18 4337 -155 0 -76 4337 -19 0 -98 4337 -14 0 -18 4337 -156 0 -75 4337 -20 0 -97 4337 -14 0 -19 4337 -155 0 -75 4337 -20 0 -97 4337 -14 0 -19 4337 -157 0 -73 4337 -20 0 -97 4337 -14 0 -19 4337 -158 0 -72 4337 -20 0 -97 4337 -14 0 -19 4337 -159 0 -71 4337 -21 0 -47 4337 -12 0 -37 4337 -14 0 -19 4337 -161 0 -36 4337 -54 0 -37 4337 -24 0 -35 4337 -14 0 -19 4337 -251 0 -32 4337 -31 0 -34 4337 -13 0 -19 4337 -253 0 -26 4337 -38 0 -31 4337 -13 0 -19 4337 -319 0 -29 4337 -13 0 -19 4337 -321 0 -27 4337 -13 0 -19 4337 -322 0 -26 4337 -13 0 -19 4337 -322 0 -26 4337 -13 0 -19 4337 -323 0 -25 4337 -13 0 -19 4337 -323 0 -25 4337 -13 0 -19 4337 -324 0 -25 4337 -12 0 -19 4337 -324 0 -25 4337 -10 0 -21 4337 -325 0 -25 4337 -9 0 -21 4337 -325 0 -25 4337 -8 0 -22 4337 -325 0 -26 4337 -6 0 -23 4337 -325 0 -27 4337 -5 0 -23 4337 -325 0 -28 4337 -4 0 -23 4337 -325 0 -29 4337 -3 0 -23 4337 -325 0 -31 4337 0 -23 4337 -325 0 -54 4337 -326 0 -54 4337 -326 0 -54 4337 -326 0 -54 4337 -327 0 -53 4337 -327 0 -53 4337 -328 0 -52 4337 -329 0 -51 4337 -330 0 -49 4337 -331 0 -49 4337 -332 0 -47 4337 -334 0 -44 4337 -338 0 -39 4337 -343 0 -35 4337 -106 0)
    )
    (tilemap
      (solid #t)
      (z-pos -1)
      (width 380)
      (height 120)
      (tiles -91 0 212 -379 0 212 -379 0 212 -379 0 212 -379 0 212 -379 0 212 -379 0 212 -379 0 212 -379 0 212 -379 0 212 -379 0 212 -379 0 212 -379 0 212 -379 0 212 -379 0 212 -379 0 212 -379 0 212 -379 0 212 -379 0 212 -379 0 212 -379 0 212 -379 0 212 -379 0 212 -379 0 212 -379 0 212 -379 0 212 -379 0 212 -379 0 212 -379 0 212 -379 0 212 -379 0 212 -379 0 212 -379 0 212 -379 0 212 -379 0 212 -379 0 212 -379 0 212 -379 0 212 -379 0 212 -379 0 212 -379 0 212 -379 0 212 -379 0 213 -3117 0 2019 2140 2141 2142 2019 2140 2141 2142 2019 2140 2141 2142 2019 2140 2141 2142 -361 0 -22 2020 -355 0 -30 2020 -349 0 -35 2020 -265 0 2019 2140 2141 2142 2019 2140 2141 2142 2019 2140 2141 2142 -67 0 -38 2020 -262 0 -16 2020 -62 0 -43 2020 -258 0 -17 2020 -62 0 -46 2020 -254 0 -19 2020 -20 0 2019 2140 2141 2142 2019 2140 -34 0 -50 2020 -250 0 -21 2020 -18 0 -8 2020 -32 0 -54 2020 -245 0 -50 2020 -31 0 -57 2020 -240 0 -54 2020 -28 0 -60 2020 -236 0 -57 2020 -26 0 -64 2020 -232 0 -58 2020 -26 0 -68 2020 -226 0 -61 2020 -25 0 -70 2020 -41 0 2019 2140 2141 2142 2019 2140 2141 2142 2019 2140 2141 -170 0 -63 2020 -24 0 -74 2020 -37 0 -13 2020 -168 0 -64 2020 -24 0 -77 2020 -34 0 -14 2020 -166 0 -65 2020 -24 0 -80 2020 -30 0 -16 2020 -164 0 -67 2020 -22 0 -84 2020 -26 0 -17 2020 -164 0 -67 2020 -22 0 -87 2020 -23 0 -17 2020 -163 0 -68 2020 -22 0 -91 2020 -18 0 -19 2020 -161 0 -69 2020 -22 0 -94 2020 -15 0 -19 2020 -160 0 -70 2020 -22 0 -97 2020 -12 0 -20 2020 -159 0 -70 2020 -22 0 -98 2020 -11 0 -20 2020 -159 0 -70 2020 -22 0 -98 2020 -11 0 -20 2020 -159 0 -70 2020 -22 0 -98 2020 -11 0 -20 2020 -159 0 -70 2020 -22 0 -99 2020 -11 0 -19 2020 -159 0 -70 2020 -22 0 -99 2020 -11 0 -20 2020 -158 0 -70 2020 -22 0 -99 2020 -11 0 -20 2020 -158 0 -70 2020 -22 0 -99 2020 -11 0 -20 2020 -158 0 -69 2020 -23 0 -100 2020 -10 0 -20 2020 -158 0 -69 2020 -23 0 -100 2020 -10 0 -20 2020 -158 0 -68 2020 -24 0 -100 2020 -10 0 -20 2020 -159 0 -66 2020 -25 0 -100 2020 -10 0 -21 2020 -158 0 -64 2020 -28 0 -99 2020 -10 0 -21 2020 -158 0 -62 2020 -30 0 -99 2020 -10 0 -21 2020 -159 0 -56 2020 -35 0 -99 2020 -10 0 -21 2020 -161 0 -50 2020 -40 0 -98 2020 -11 0 -20 2020 -163 0 -38 2020 -50 0 -98 2020 -11 0 -20 2020 -168 0 -27 2020 -56 0 -98 2020 -11 0 -21 2020 -251 0 -97 2020 -11 0 -21 2020 -253 0 -95 2020 -11 0 -21 2020 -256 0 -93 2020 -10 0 -21 2020 -259 0 -90 2020 -10 0 -22 2020 -261 0 -87 2020 -10 0 -22 2020 -265 0 -83 2020 -10 0 -22 2020 -271 0 -78 2020 -9 0 -22 2020 -276 0 -73 2020 -9 0 -22 2020 -281 0 -68 2020 -9 0 -22 2020 -287 0 -63 2020 -8 0 -22 2020 -292 0 -58 2020 -8 0 -22 2020 -296 0 -55 2020 -7 0 -22 2020 -301 0 -50 2020 -7 0 -22 2020 -305 0 -46 2020 -7 0 -22 2020 -308 0 -44 2020 -6 0 -22 2020 -310 0 -42 2020 -5 0 -22 2020 -314 0 -40 2020 -4 0 -22 2020 -315 0 -40 2020 -2 0 -23 2020 -317 0 -63 2020 -318 0 -62 2020 -318 0 -61 2020 -320 0 -59 2020 -322 0 -56 2020 -324 0 -55 2020 -326 0 -53 2020 -328 0 -50 2020 -332 0 -45 2020 -336 0 -40 2020 -342 0 -35 2020 -347 0 -30 2020 -359 0 -9 2020 -128 0)
    )
    (tilemap
      (solid #f)
      (z-pos 100)
      (width 380)
      (height 120)
      (tiles -20487 0 130 -379 0 129 -379 0 129 -379 0 129 -379 0 129 -379 0 129 -379 0 129 -379 0 129 -22452 0)
    )
    (toad
      (z-pos 50)
      (x 1472)
      (y 1472)
      (glinting #f)
    )
    (toad
      (z-pos 50)
      (x 6688)
      (y 2592)
      (glinting #f)
    )
    (toad
      (z-pos 50)
      (x 4608)
      (y 1664)
      (glinting #f)
    )
    (toad
      (z-pos 50)
      (x 3808)
      (y 2560)
      (glinting #f)
    )
    (toad
      (z-pos 50)
      (x 2848)
      (y 2656)
      (glinting #f)
    )
    (totem
      (z-pos 50)
      (x 5344)
      (y 1536)
      (glinting #f)
    )
    (totem
      (z-pos 50)
      (x 2240)
      (y 1600)
      (glinting #f)
    )
    (totem
      (z-pos 50)
      (x 4736)
      (y 1664)
      (glinting #f)
    )
    (totem
      (z-pos 50)
      (x 5344)
      (y 1504)
      (glinting #f)
    )
    (totem
      (z-pos 50)
      (x 6912)
      (y 1184)
      (glinting #f)
    )
    (totem
      (z-pos 50)
      (x 6912)
      (y 1152)
      (glinting #f)
    )
    (totem
      (z-pos 50)
      (x 9376)
      (y 1856)
      (glinting #f)
    )
    (totem
      (z-pos 50)
      (x 9376)
      (y 1824)
      (glinting #f)
    )
    (wind
      (type "current")
      (z-pos 0)
      (speed-x 300)
      (speed-y 0)
      (acceleration 100)
      (affects-player #t)
      (width 576)
      (height 96)
      (x 6912)
      (y 2432)
    )
    (wind
      (type "current")
      (z-pos 0)
      (speed-x 0)
      (speed-y 300)
      (acceleration 100)
      (affects-player #t)
      (width 384)
      (height 960)
      (x 7488)
      (y 2432)
    )
  )
)
