(supertux-level
  (version 3)
  (name (_ "Welcome To PepperTux"))
  (author "Sophie \"Vaesea\" Ball")
  (license "CC-BY-SA 4.0 International")
  (target-time 49)
  (allow-item-pocket "inherit")
  (icon "")
  (icon-locked "")
  (statistics
    (enable-coins #t)
    (enable-secrets #t)
  )
  (sector
    (name "main")
    (ambient-light
      (color 1 1 1)
    )
    (background
      (color 1 1 1)
      (alignment "bottom")
      (speed 0.5)
      (speed-y 0)
      (image "images/background/arctis2.png")
    )
    (camera
      (name "Camera")
      (mode "normal")
    )
    (coin
      (z-pos 49)
      (x 9312)
      (y 768)
    )
    (coin
      (z-pos 49)
      (x 9344)
      (y 768)
    )
    (coin
      (z-pos 49)
      (x 9376)
      (y 768)
    )
    (coin
      (z-pos 49)
      (x 9408)
      (y 768)
    )
    (decal
      (z-pos 100)
      (sprite "/images/decal/snow/exitfg.png")
      (x 12576)
      (y 672)
    )
    (decal
      (z-pos -100)
      (sprite "/images/decal/snow/exitbg.png")
      (x 12480)
      (y 672)
    )
    (firefly
      (z-pos 0)
      (x 5280)
      (y 864)
    )
    (gradient
      (top_color 0.5 0.7 1)
      (bottom_color 1 1 1)
      (z-pos -400)
    )
    (jumpy
      (z-pos 50)
      (x 4736)
      (y 736)
      (glinting #f)
    )
    (jumpy
      (z-pos 50)
      (x 5184)
      (y 736)
      (glinting #f)
    )
    (jumpy
      (z-pos 50)
      (x 7520)
      (y 608)
      (glinting #f)
    )
    (mriceblock
      (z-pos 50)
      (direction "left")
      (x 2912)
      (y 864)
      (glinting #f)
    )
    (mriceblock
      (z-pos 50)
      (direction "left")
      (x 4992)
      (y 896)
      (glinting #f)
    )
    (mriceblock
      (z-pos 50)
      (direction "left")
      (x 9312)
      (y 896)
      (glinting #f)
    )
    (music
      (file "/music/chipdisko.ogg")
    )
    (sequencetrigger
      (sequence "endsequence")
      (width 32)
      (height 864)
      (x 12256)
      (y 0)
    )
    (sequencetrigger
      (sequence "stoptux")
      (width 32)
      (height 416)
      (x 12768)
      (y 544)
    )
    (smartball
      (z-pos 50)
      (direction "left")
      (x 2592)
      (y 544)
      (glinting #f)
    )
    (smartball
      (z-pos 50)
      (direction "left")
      (x 11296)
      (y 800)
      (glinting #f)
    )
    (smartblock
      (z-pos 50)
      (direction "left")
      (x 10112)
      (y 736)
      (glinting #f)
    )
    (snowball
      (z-pos 50)
      (direction "left")
      (x 1472)
      (y 768)
      (glinting #f)
    )
    (snowball
      (z-pos 50)
      (direction "left")
      (x 2656)
      (y 864)
      (glinting #f)
    )
    (snowball
      (z-pos 50)
      (direction "left")
      (x 4160)
      (y 864)
      (glinting #f)
    )
    (snowball
      (z-pos 50)
      (direction "left")
      (x 4352)
      (y 864)
      (glinting #f)
    )
    (snowball
      (z-pos 50)
      (direction "left")
      (x 7328)
      (y 832)
      (glinting #f)
    )
    (snowball
      (z-pos 50)
      (direction "left")
      (x 6880)
      (y 800)
      (glinting #f)
    )
    (snowball
      (z-pos 50)
      (direction "left")
      (x 6784)
      (y 768)
      (glinting #f)
    )
    (snowball
      (z-pos 50)
      (direction "left")
      (x 10912)
      (y 736)
      (glinting #f)
    )
    (snowball
      (z-pos 50)
      (direction "left")
      (x 10528)
      (y 704)
      (glinting #f)
    )
    (spawnpoint
      (name "main")
      (x 64)
      (y 832)
    )
    (spiky
      (z-pos 50)
      (direction "left")
      (x 8320)
      (y 832)
      (glinting #f)
    )
    (spiky
      (z-pos 50)
      (direction "left")
      (x 7936)
      (y 832)
      (glinting #f)
    )
    (spiky
      (z-pos 50)
      (direction "left")
      (x 7552)
      (y 832)
      (glinting #f)
    )
    (stalactite
      (glinting #f)
      (z-pos -1)
      (x 9952)
      (y 480)
    )
    (stalactite
      (glinting #f)
      (z-pos -1)
      (x 10144)
      (y 480)
    )
    (stalactite
      (glinting #f)
      (z-pos -1)
      (x 10464)
      (y 416)
    )
    (stalactite
      (glinting #f)
      (z-pos -1)
      (x 10752)
      (y 416)
    )
    (stalactite
      (glinting #f)
      (z-pos -1)
      (x 10976)
      (y 352)
    )
    (stalactite
      (glinting #f)
      (z-pos -1)
      (x 11328)
      (y 512)
    )
    (stalactite
      (glinting #f)
      (z-pos -1)
      (x 11360)
      (y 512)
    )
    (stalactite
      (glinting #f)
      (z-pos -1)
      (x 11392)
      (y 512)
    )
    (tilemap
      (solid #f)
      (z-pos -100)
      (width 400)
      (height 35)
      (tiles -1937 0 -9 2180 -386 0 -5 2180 2195 2197 2187 2195 2197 2187 2195 2197 2187 -3 2180 -376 0 -8 2180 2181 2196 2180 2181 2196 2180 2181 2196 2180 2181 2196 2180 2181 2196 2180 2181 2180 -303 0 85 86 87 88 -64 0 -5 2180 2188 2189 2179 2188 2189 2179 2188 2189 2179 2188 2189 2179 2188 2189 2179 2188 2189 2179 2188 2189 2179 2188 2189 2179 -2 2180 -301 0 89 90 91 92 -60 0 -4 2180 2187 2195 2197 2187 2195 2197 2187 2195 2197 2187 2195 2197 2187 2195 2197 2187 2195 2197 2187 2195 2197 2187 2195 2197 2187 2195 2197 2187 2195 2197 -2 2180 -99 0 85 86 87 88 -157 0 85 86 87 88 -98 0 -3 2180 2181 2196 2180 2181 2196 2180 2181 2196 2180 2181 2196 2180 2181 2196 2180 2181 2196 2180 2181 2196 2180 2181 2196 2180 2181 2196 2180 2181 2196 2180 2181 2196 2180 2181 2180 -99 0 89 90 91 92 -70 0 85 86 87 88 -83 0 89 90 91 92 -97 0 -2 2180 2179 2188 2189 2179 2188 2189 2179 2188 2189 2179 2188 2189 2179 2188 2189 2179 2188 2189 2179 2188 2189 2179 2188 2189 2179 2188 2189 2179 2188 2189 2179 2188 2189 2179 2188 2189 2179 2180 -37 0 85 86 87 88 -131 0 89 90 91 92 -167 0 85 86 87 88 -10 0 -3 2180 2197 2187 2195 2197 2187 2195 2197 2187 2195 2197 2187 2195 2197 2187 2195 2197 2187 2195 2197 2187 2195 2197 2187 2195 2197 2187 2195 2197 2180 2181 2196 2187 2195 2197 2187 2195 2197 2187 2195 2197 2180 -36 0 89 90 91 92 -17 0 85 86 87 88 -149 0 85 86 87 88 -128 0 89 90 91 92 -8 0 -3 2180 2181 2196 2180 2181 2196 2180 2181 2196 2180 2181 2196 2180 2181 2196 2180 2181 2196 2180 2181 2196 2180 2181 2196 2180 2181 2196 2180 2181 2180 2181 2188 2189 2179 2181 2196 2180 2181 2196 2180 2181 2196 2180 2181 2180 -56 0 89 90 91 92 -77 0 85 86 87 88 -68 0 89 90 91 92 -139 0 -2 2180 2179 2188 2189 2179 2188 2189 2179 2188 2189 2179 2188 2189 2179 2188 2189 2179 2188 2180 2181 2196 2189 2180 2181 2196 2179 2188 2189 2179 2188 2189 2188 2189 2197 2187 2195 2180 2181 2196 2189 2179 2188 2189 2179 2188 2189 2179 2180 -7 0 85 86 87 88 -125 0 89 90 91 92 -211 0 2180 2187 2195 2197 2187 2195 2197 2187 2195 2197 2187 2195 2197 2187 2180 2181 2196 2195 2197 2188 2189 2179 2187 2188 2189 2179 2196 2197 2187 2195 2197 2187 2197 2187 2195 2181 2196 2188 2189 2179 2187 2195 2197 2187 2195 2197 2187 2195 -2 2180 -6 0 89 90 91 92 -339 0 2193 2184 2181 2196 -2 2180 2181 2196 2181 2196 2180 2181 2196 2180 2181 2188 2189 2180 2181 -2 2196 2187 2180 2181 2197 2187 2195 2179 2180 2181 2196 2180 2181 2196 2180 2181 2196 2179 2197 2187 2180 2181 2196 -2 2180 2181 2196 2181 2196 -2 2180 -350 0 2193 2184 2179 -2 2188 2189 2179 2196 2179 2188 2189 2179 2188 2189 2180 2181 2196 2189 2179 2180 2181 2196 2189 2179 2197 2187 2195 2180 2181 2196 2188 2189 2179 2188 2189 2179 2195 2181 2196 2188 2189 2179 -2 2188 2189 2179 2189 2179 2188 2182 2194 -350 0 2192 2195 -2 2197 2187 2195 2179 2180 2197 2187 2195 2180 2181 2188 2189 2179 2187 2195 2188 2189 2179 2187 -2 2195 2187 2195 2188 2180 2181 2196 2187 2195 2197 2187 2195 2188 2189 2179 2197 2187 2195 -2 2197 2187 2195 2187 2195 2182 2194 -351 0 2193 2184 2180 2181 2197 2187 2195 2188 2189 2179 2196 2188 2189 2197 2187 2195 2196 2180 2197 2187 2195 2181 2196 2180 2181 2196 2197 2188 2189 2179 2181 2196 2180 2181 2196 2197 2187 -2 2180 2181 2196 2180 2181 2196 2180 2181 2196 2190 -25 0 130 -327 0 2192 2188 2189 2179 2188 2189 2197 2187 2195 2179 2197 2187 2180 2181 2196 -2 2180 2181 2196 2188 2189 2179 2188 2189 2179 2188 2197 2187 2195 2189 2179 2188 2189 2179 -2 2180 2181 2196 2189 2179 2181 2196 2179 2188 2189 2182 2194 -25 0 129 -228 0 122 123 -96 0 2185 2200 2180 2181 2196 2197 2187 2180 2181 2196 2195 2180 2181 2188 2189 2179 -2 2188 2189 2179 2197 2187 2195 2197 2187 2195 -2 2197 2187 2195 2187 2180 2181 -2 2196 -2 2188 2189 2179 2187 2195 2189 2179 2195 2197 2187 2190 -26 0 129 -54 0 122 123 -169 0 122 123 0 124 125 -51 0 122 123 -43 0 2192 2196 2188 2189 2179 2180 2181 2188 2189 2179 2196 2188 2189 2197 2187 2195 -2 2197 2187 2195 2180 2181 2196 2180 2181 2196 2180 2181 2196 2180 2181 2188 2189 -2 2179 -2 2197 2187 2195 -2 2197 2187 2195 2196 2180 2181 2190 -26 0 129 -54 0 124 125 -21 0 24 -147 0 124 125 0 124 125 -51 0 124 125 -43 0 2192 2179 2197 2187 2195 2188 2180 2181 2196 2195 2179 2197 2187 -2 2195 2189 2179 2188 2189 2179 2188 2189 2179 2188 2189 2179 2188 2189 2179 2188 2189 2197 2187 -2 2195 2188 2180 2181 2196 2187 2195 2188 2189 2179 2188 2189 2198 2186 -25 0 129 -41 0 106 107 108 -10 0 124 125 -44 0 122 123 -123 0 124 125 0 124 125 -51 0 124 125 -43 0 2192 2195 2197 2187 2180 2181 2196 2189 2179 2187 2195 2197 2187 2195 2197 2187 2195 2197 2187 2195 2197 2187 2195 2197 2187 2195 2197 2187 2195 2197 2187 2195 2197 2187 2195 2197 2188 2189 2179 2187 2195 2197 2187 2195 2197 2187 2195 2190 -25 0 129 -41 0 109 110 111 -7 0 24 -2 0 124 125 -2 0 25 -41 0 124 125 -2 0 122 123 -34 0 122 123 -79 0 24 0 25 0 124 125 24 124 125 -51 0 124 125 -15 0 122 123 -25 0 2185 2200 2196 -2 2180 2181 2196 2179 2187 2195 2181 2196 2180 2181 2196 2180 2181 2196 2180 2181 2196 2180 2181 2196 2180 2181 2196 2180 2181 2196 2180 2181 2196 2180 2181 2196 2180 2197 2187 2195 2181 2196 2180 2181 2196 2180 2181 2196 2198 2186 -24 0 129 -17 0 122 123 -81 0 124 125 -2 0 124 125 -2 0 122 123 -30 0 124 125 -56 0 106 107 108 -11 0 122 123 -27 0 106 107 108 -31 0 106 107 108 -3 0 124 125 -11 0 122 123 -2 0 124 125 -2 0 122 123 -21 0 2192 2189 2179 2188 2180 2181 2196 2195 2179 2188 2189 2179 2188 2189 2179 2188 2189 2179 2188 2189 2179 2188 2189 2179 2188 2189 2179 2188 2189 2179 2188 2189 2179 2188 2189 2179 2188 2189 2179 2188 2189 2179 2188 2189 2179 2187 2197 2195 2188 2198 2186 -23 0 129 -17 0 124 125 -3 0 106 107 108 -69 0 106 107 108 -3 0 124 125 -2 0 124 125 -2 0 124 125 -30 0 124 125 -6 0 106 107 108 -44 0 24 -2 0 109 110 111 0 25 -9 0 124 125 -23 0 25 0 24 0 109 110 111 -9 0 25 24 -8 0 24 -6 0 25 -4 0 109 110 111 -3 0 124 125 0 24 -9 0 124 125 -2 0 124 125 -2 0 124 125 -21 0 2192 2187 2195 2197 2188 2189 2179 2187 2195 2197 2187 2195 2197 2187 2195 2197 2187 2195 2197 2187 2195 2197 2187 2195 2197 2187 2195 2197 2187 2195 2197 2187 2195 2197 2187 2195 2197 2187 2195 2197 2187 2195 2197 2187 -2 2195 2179 2196 2179 2197 2186 -11 0 24 -11 0 129 -4 0 24 -12 0 124 125 -3 0 109 110 111 0 24 -4 0 25 -51 0 25 -6 0 24 -3 0 109 110 111 -3 0 124 125 -2 0 124 125 24 0 124 125 -19 0 24 -6 0 25 -3 0 124 125 -2 0 24 -3 0 109 110 111 -35 0 106 107 108 -23 0 124 125 -80 0 124 125 -2 0 124 125 -2 0 124 125 -20 0 2185 2200 2181 2196 2180 2197 2187 2195 2181 2196 2180 2181 2196 2180 2181 2196 2180 2181 2196 2180 2181 2196 2180 2181 2196 2180 2181 2196 2180 2181 2196 2180 2181 2196 2180 2181 2196 2180 2181 2196 2180 2181 2196 2180 2181 2196 2187 2197 2187 2197 2195 2198 2199 2186 -2 0 2185 -4 2199 2186 -118 0 2185 -4 2199 2186 -18 0 2185 -5 2199 2186 -23 0 24 -7 0 24 -2 0 25 -5 0 24 -10 0 109 110 111 -23 0 124 125 -80 0 124 125 -2 0 124 125 0 24 124 125 -11 0 24 -9 0 2179 2181 2179 -42 2180 2181 2189 2180 2189 2181 2195 2196 2198 -2 2199 2200 2197 -2 2179 2196 2190 -118 0 2192 2181 2197 2196 2179 2198 2186 -17 0 2192 2195 2180 2187 2197 2179 2198 2186 -187 0 2185 2199 2200 2179 2198 2199 2186 -39 0 2185 2200 2197 2187 2197 2195 -2 2180 2197 -2 2181 2179 2187 -2 2196 2195 2190 -118 0 2192 2197 2188 2180 2188 2197 2198 2186 -15 0 2185 2200 2189 2180 2195 2180 2189 2196 2190 -185 0 2185 2199 2200 2195 2196 -2 2188 2197 2190 -39 0 2192 2197 2179 2196 2179 2197 2188 2189 2180 2187 2195 2189 2179 2188 2189 2188 2198 2199 2186 -116 0 2192 2180 2195 2188 2189 2179 2197 2198 2199 2186 -12 0 2185 2200 2188 2181 2179 2195 2181 2196 2181 2190 -180 0 2185 -4 2199 2200 2197 2196 2179 2196 2179 2195 2197 2190 -37 0 2185 2199 2200 2196 2179 2195 2179 2197 2188 2189 2181 2195 2197 2196 2188 2196 -3 2179 2195 2190 -116 0 2192 2180 2187 -2 2181 2196 2187 2181 2196 2198 -6 2199 2186 -2 0 2185 -2 2199 2200 2196 2197 2179 2196 2187 2181 2179 2187 2190 -176 0 2185 -3 2199 2200 2181 2179 2180 2189 2181 2188 -2 2197 2181 2179 2189 2181 2198 -2 2199 2186 -34 0 2192 2187 2196 2189 2195 2188 2196 2195 2180 2188 2180 2195 2179 2197 2187 2179 2189 -2 2187 2188 2190 -116 0 2192 2197 2180 -2 2197 2181 2179 2181 2179 2180 2181 2196 2180 2181 2196 2188 2198 -2 2199 2200 2180 2181 2187 2179 2181 -2 2189 2188 2181 2179 2197 2190 -176 0 2192 2181 2195 2180 -2 2179 2189 -2 2180 2187 2181 2189 -2 2179 -2 2187 2180 2181 2197 2180 2190 -34 0 2192 2179 2181 2197 2180 2197 2181 2180 2196 2179 2197 2189 2196 2197 2195 2181 2195 -3 2179 2190 -116 0 2192 2181 2189 -2 2179 2189 2181 2189 2195 2188 2189 2179 2188 2189 2179 2197 2180 2181 2196 2187 2188 2189 2187 2180 2187 2197 -5 2179 2194 -176 0 2193 2183 2179 2180 2187 2181 2180 2189 -2 2180 2187 2188 2187 2181 2189 2180 2189 2180 -2 2187 2194 -34 0 2193 2183 2188 2179 2188 2180 -2 2187 2180 -2 2189 2179 2189 2195 2187 2181 2196 2180 2189 2187 2194 -29 0)
    )
    (tilemap
      (solid #f)
      (z-pos 100)
      (width 400)
      (height 35)
      (tiles -7584 0 130 -399 0 129 -399 0 129 -399 0 129 -399 0 129 -399 0 129 -399 0 129 -399 0 129 -399 0 129 -3215 0)
    )
    (tilemap
      (solid #t)
      (z-pos 0)
      (width 400)
      (height 35)
      (tiles -177 0 10 -3 11 19 -7 11 12 -117 0 10 -50 11 12 -218 0 10 -11 11 12 -117 0 10 -50 11 12 -218 0 10 11 19 -9 11 12 -117 0 10 -50 11 12 -218 0 10 -2 11 19 -8 11 12 -117 0 10 -50 11 12 -218 0 10 -11 11 12 -117 0 10 -50 11 12 -218 0 10 -9 11 19 11 12 -117 0 10 -50 11 12 -218 0 10 19 -10 11 12 -117 0 10 -50 11 12 -218 0 10 -3 11 19 -7 11 12 -117 0 10 -50 11 12 -218 0 10 -11 11 12 -117 0 10 -50 11 12 -218 0 10 -11 11 12 -117 0 10 -50 11 12 -218 0 10 -11 11 12 -117 0 10 -50 11 12 -218 0 10 -11 11 12 -117 0 10 -32 11 2929 2930 -3 17 2925 2926 -11 11 12 -218 0 10 -11 11 12 -117 0 10 -30 11 2929 2930 2931 -5 0 2928 2933 -10 11 12 -218 0 10 11 19 -4 11 19 -4 11 12 -117 0 10 -15 11 2929 2930 -13 17 2931 -8 0 2934 2925 2926 -8 11 12 -120 0 128 -97 0 10 19 -8 11 19 11 12 -117 0 10 -13 11 2929 2930 2931 -25 0 2928 2933 -7 11 12 -218 0 10 19 -10 11 12 -117 0 16 -13 17 2931 -28 0 2934 2925 2926 -5 11 12 -218 0 10 -2 11 19 -8 11 12 -162 0 2928 -5 17 18 -218 0 10 -8 11 19 -2 11 12 -367 0 128 -19 0 10 -3 11 19 -7 11 12 -72 0 44 -314 0 10 -11 11 12 -71 0 44 0 44 -262 0 -9 78 -42 0 16 2925 2926 -7 11 2929 2930 18 -236 0 78 -2 83 102 -2 83 78 -7 0 78 -5 83 78 -79 0 78 -7 44 78 -44 0 2928 -4 17 3991 -2 17 2931 -44 0 1549 -4 1540 1541 -93 0 2909 2910 2913 2914 -85 0 44 -35 0 7 -4 8 9 -58 0 -3 83 -3 0 78 -7 44 78 -21 0 1551 1540 1541 -72 0 -2 1549 -8 0 1551 -2 1540 1541 -84 0 3141 3142 2911 2912 2915 2916 2917 2918 2913 2914 -80 0 44 -36 0 13 14 3990 -2 14 15 -64 0 78 -7 44 78 -18 0 1551 -2 1540 1541 -74 0 1543 1544 -15 0 1551 -2 1540 1541 -63 0 2909 2910 2913 2914 -9 0 3150 3145 3146 1834 -2 11 1835 2919 2920 2915 2916 2917 2918 2913 2914 -75 0 44 -2 0 7 -29 8 9 -4 0 10 -4 11 12 -52 0 -3 83 -9 0 -9 78 -15 0 1551 -2 1540 1541 -47 0 2909 2910 -9 8 2913 2914 -17 0 1547 1548 -22 0 1551 -2 1540 1541 -54 0 3141 3142 2911 2912 2915 2916 2917 2918 2913 2914 -4 0 3153 3154 3148 -8 11 1835 2919 2920 2915 2916 2917 2918 2913 2914 -74 0 13 -8 14 3990 -2 14 3990 -5 14 3989 -2 14 3990 14 3989 -6 14 15 -4 0 10 -4 11 12 -85 0 1551 -2 1540 1541 -10 0 -3 83 -3 0 83 102 83 -29 0 3141 3142 2911 2912 3990 -7 14 3990 2915 2916 2917 2918 2913 2914 -13 0 1543 1544 -79 0 3150 3145 3146 1834 -2 11 1835 2919 2920 2915 2916 2917 2918 2921 2922 3157 3158 -13 11 1835 2919 2920 2915 2916 2917 2918 -9 8 9 -60 0 2909 2910 22 -10 11 19 -16 11 2929 2930 18 -4 0 10 -4 11 12 -115 0 7 -5 8 2178 -5 8 9 -8 0 3150 3145 3146 1834 -7 11 19 -3 11 1835 2919 2920 2915 2916 2917 2918 -11 8 1547 1548 -36 8 9 -41 0 3153 3154 3148 -7 11 19 1835 2919 2920 2923 2924 1834 -18 11 1835 2919 2920 -9 14 15 -4 0 7 -53 8 2921 2922 2911 2912 23 -5 11 19 -20 11 2935 2931 -6 0 10 -4 11 21 -31 8 9 -17 0 7 -24 8 2913 2914 -39 0 13 -6 14 3990 -2 14 3990 14 15 -7 0 3153 3154 3148 -17 11 1835 2919 2920 -3 14 3990 14 3990 14 3990 -16 14 3989 -2 14 3990 -8 14 3988 14 3988 14 3989 -3 14 3988 -2 14 3990 14 15 -37 0 7 8 2921 2922 3157 3158 -6 11 19 -36 11 2929 2930 18 -4 0 13 14 3988 -2 14 3989 -6 14 3990 -29 14 -2 3990 -6 14 3988 -3 14 2923 2924 1834 -18 11 19 -8 11 2935 2936 -7 0 10 -4 11 20 -2 14 3988 -3 14 3989 -2 14 3989 -2 3990 -17 14 3990 14 15 -17 0 13 -12 14 3990 14 3988 -3 14 3990 -4 14 3990 2915 2916 2917 2918 -32 8 9 -4 0 10 -11 11 12 -4 0 7 2921 2922 3157 3158 -40 11 19 11 19 -25 11 2929 2930 18 -4 0 7 -27 8 9 -4 0 13 14 2923 2924 1834 -43 11 2935 2931 -6 0 16 2925 2926 -19 11 19 -5 11 115 116 -16 11 19 -9 11 19 -26 11 2940 2936 -8 0 10 -34 11 2929 2930 18 -17 0 16 2925 2926 -17 11 19 -5 11 1835 2919 2920 3989 -4 14 3989 -3 14 3990 -17 14 3990 -2 14 3989 3990 15 -4 0 10 -11 11 12 -4 0 13 2923 2924 1834 -24 11 19 -43 11 2935 2931 -6 0 13 14 3990 -2 14 3990 -2 14 3990 3989 -2 14 3990 14 3990 14 3990 14 3990 -3 14 3990 -2 14 3990 -2 14 15 -4 0 16 2925 2926 -4 11 19 -13 11 19 -18 11 19 -6 11 2940 2936 -9 0 2928 2933 -24 11 117 118 -7 11 115 116 -20 11 19 -23 11 2941 -9 0 10 -8 11 19 -19 11 115 116 -3 11 2935 2931 -21 0 2928 2933 19 -54 11 2929 2930 18 -4 0 10 -8 11 115 116 11 12 -4 0 16 2925 2926 -26 11 19 -6 11 19 -34 11 2940 2936 -7 0 16 2925 2926 -23 11 2929 2930 18 -6 0 2928 2933 -33 11 19 -9 11 2941 -11 0 2934 2937 -26 11 19 -5 11 117 118 -13 11 19 -29 11 2940 2942 -9 0 16 2925 2926 -26 11 117 118 -2 11 2940 2936 -23 0 2934 2937 -3 11 19 -28 11 19 -2 11 19 -17 11 2935 2931 -6 0 10 -8 11 117 118 11 12 -6 0 2928 2933 -67 11 2941 -10 0 2928 2933 -21 11 2935 2931 -9 0 2934 2937 -41 11 2940 2942 -12 0 2938 -57 11 19 -6 11 19 -12 11 2941 -12 0 2928 2933 -21 11 19 -7 11 2941 -25 0 2938 -13 11 19 11 19 -3 11 19 -4 11 19 -27 11 2940 2936 -7 0 10 -11 11 12 -7 0 2934 2937 -65 11 2940 2942 -11 0 2934 2937 19 -18 11 2940 2936 -11 0 2938 -8 11 19 -32 11 2941 -13 0 2939 2937 -75 11 2940 2942 -13 0 2934 2937 -27 11 2940 2942 -25 0 2939 2937 -50 11 19 2941 -8 0 10 -11 11 12 -8 0 2938 -65 11 2941 -13 0 2938 -8 11 19 -10 11 2941 -12 0 2939 2937 -14 11 19 11 19 -22 11 30 2942 -14 0 2938 -39 11 19 -35 11 2941 -15 0 2938 -27 11 2941 -27 0 2938 -47 11 19 -2 11 2940 2942 -8 0 10 -5 11 19 -5 11 12 -8 0 2939 2937 -26 11 19 -16 11 19 -5 11 19 -13 11 2940 2942 -13 0 2939 2937 -5 11 19 -11 11 2940 2942 -13 0 2938 -2 11 19 -36 11 12 -15 0 2939 31 -30 11)
    )
    (tilemap
      (solid #t)
      (z-pos -101)
      (width 400)
      (height 35)
      (tiles -6876 0 2067 -5 2068 2069 -393 0 2072 -5 2073 2074 -392 0 2052 2056 2060 2061 2060 2061 2066 2055 2054 -382 0 2067 -5 2068 2069 0 2052 2060 2061 2071 2070 2065 2060 2061 2066 2055 2054 0 2067 -5 2068 2069 -365 0 2085 2086 -6 0 2072 -5 2073 2074 2052 2056 2065 2066 2058 2060 2058 2065 2060 2061 2066 2055 2054 2072 -5 2073 2074 -199 0 83 102 -164 0 2087 2088 -6 0 2057 2060 2061 2060 2061 2066 2055 2056 2060 2058 2060 2058 2060 2061 2058 -2 2060 2061 2066 2055 2056 2060 2061 2066 2070 2066 2059 -373 0 2057 2065 2066 2065 2066 2061 2060 2061 2065 2058 2060 2058 2065 2066 2071 -2 2065 2066 2060 2061 2060 2061 2060 2061 2066 2061 2059 -169 0 1542 -202 0 2052 2056 2058 2060 2070 2060 2058 2065 2066 2058 2060 2058 2060 2061 2065 2066 -2 2058 2060 2065 2060 2065 2066 2070 -2 2058 2050 2064 -6 0 2067 -5 2068 2069 -156 0 1546 -27 0 2067 -4 2068 2069 -168 0 2052 2056 2060 2061 2060 2061 -2 2060 2061 2070 2060 2061 2060 2065 2066 -2 2060 2061 -2 2060 2061 2060 2058 2060 -2 2058 2050 2064 -7 0 2072 -5 2073 2074 -156 0 1546 -27 0 2072 -4 2073 2074 -165 0 -3 2053 2056 2060 2061 2060 2065 2066 -2 2065 2066 -2 2065 2066 -2 2065 2066 -2 2065 2066 -2 2065 2060 2061 2060 -2 2058 2050 2064 -7 0 2052 2056 2060 2061 2060 2065 2061 2055 2054 -155 0 1546 -26 0 2052 2056 2060 2061 2060 2061 2055 2054 -164 0 -2 2060 2061 2060 2065 2066 2065 2058 2060 -2 2058 2060 -2 2058 2060 -2 2058 2060 -2 2058 2060 -2 2058 2065 2066 2065 2058 2050 2064 -7 0 2052 2056 2061 2065 2066 2065 2060 2061 2060 2059 -35 0 2085 2086 -131 0 2085 2086 -11 0 2052 2056 2066 2065 2060 2065 2066 2065 2055 2054 -2 0 2085 2086 -193 0 2052 2053 2056 2060 2066 2058 2060 2070 2065 2066 2065 2055 2054 -34 0 2087 2088 -131 0 2087 2088 -10 0 2052 2056 2060 2065 2060 2065 2060 2071 2060 2061 2055 2054 0 2087 2088 -191 0 -2 2053 2056 -2 2060 2061 -2 2060 2061 2060 2058 2060 2070 2061 2059 -181 0 2065 2066 2065 2066 2065 2066 2065 2066 -3 0 2087 2088 -191 0 -2 2060 2061 2060 2065 2066 -2 2065 2066 2065 2060 2061 2060 2066 2055 2054 -191 0 2087 2088 -191 0 -2 2065 2066 2065 2058 2060 2070 2058 2060 2070 2065 2066 2065 2060 2061 2059 -191 0 2087 2088 -191 0 2070 2058 2060 2070 2060 2061 -2 2060 2061 2060 2058 2060 2070 2065 2066 2055 2054 -187 0 -3 2144 2899 2900 -191 0 -2 2060 2061 -2 2060 2061 -2 2060 2061 -2 2060 2061 -2 2060 2061 2060 2059 -187 0 -3 2147 2903 2904 -191 0 2065 -2 2061 2065 2061 2066 2061 2065 2066 -3 2061 -2 2065 -2 2061 2055 2054 -289 0)
    )
    (tilemap
      (solid #f)
      (z-pos -99)
      (width 400)
      (height 35)
      (tiles -8353 0 122 123 -377 0 24 -15 0 122 123 -3 0 124 125 -369 0 122 123 -22 0 124 125 -3 0 124 125 -362 0 24 -6 0 124 125 -22 0 124 125 -3 0 124 125 -12 0 122 123 -355 0 124 125 -22 0 124 125 -3 0 124 125 106 107 108 -9 0 124 125 -2 0 122 123 -351 0 124 125 -22 0 124 125 0 24 0 124 125 109 110 111 -9 0 124 125 -2 0 124 125 -5 0 106 107 108 -327 0 106 107 108 -54 0 25 0 124 125 -2 0 124 125 0 25 -3 0 109 110 111 -327 0 109 110 111 -368 0 25 -13 0 25 -2506 0)
    )
  )
)
