(supertux-level
  (version 3)
  (name (_ "Oh Snow"))
  (author "Sophie \"Vaesea\" Ball")
  (license "CC-BY-SA 4.0 International")
  (target-time 34)
  (allow-item-pocket "inherit")
  (icon "")
  (icon-locked "")
  (statistics
    (enable-coins #t)
    (enable-secrets #t)
  )
  (sector
    (name "main")
    (ambient-light
      (color 0.6 0.6 0.6)
    )
    (camera
      (name "Camera")
      (mode "normal")
    )
    (gradient
      (top_color 0.5 0.7 1)
      (bottom_color 1 1 1)
    )
    (music
      (file "/music/boss/bossattack.music")
    )
    (spawnpoint
      (name "main")
      (x 736)
      (y 864)
    )
    (tilemap
      (solid #f)
      (z-pos -100)
      (width 47)
      (height 35)
      (tiles -941 0 106 107 108 -42 0 106 0 109 110 111 0 24 0 25 -31 0 25 -3 0 24 -2 0 109 -265 0 106 107 108 -28 0 24 -3 0 -2 25 -3 0 25 -3 0 24 -2 0 109 110 111 -296 0)
    )
    (tilemap
      (solid #f)
      (z-pos 100)
      (width 47)
      (height 35)
      (tiles -1645 0)
    )
    (tilemap
      (solid #t)
      (z-pos 0)
      (width 47)
      (height 35)
      (tiles -752 11 -47 17 -188 0 -10 8 9 -25 0 7 -10 8 -10 14 15 -25 0 13 -10 14 -10 11 12 -25 0 10 -20 11 12 -25 0 10 -18 11 2929 2930 18 -25 0 16 2925 2926 -15 11 2935 2931 -29 0 2928 2933 -13 11 2940 2936 -31 0 2934 2937 -12 11 2941 -4 0 7 -23 8 9 -4 0 2938 -11 11 2935 2942 -4 0 13 -23 14 15 -4 0 2939 2933 -9 11 2935 2936 -5 0 16 2925 2926 -19 11 2929 2930 18 -5 0 2934 2933 -3 11 19 -3 11 2935 2936 -8 0 2928 2933 19 -16 11 2935 2931 -8 0 2934 2933 -5 11 2935 2936 -10 0 2934 2937 -15 11 2940 2936 -10 0 2934 2937 -3 11 2940 2936 -12 0 2938 -15 11 2941 -12 0 2938 11 19 11 2941 -13 0 2939 2937 -13 11 2940 2942 -12 0 2939 2937 11)
    )
    (tilemap
      (solid #f)
      (speed-x 0.5)
      (speed-y 0.5)
      (tint 0.5 0.5 0.5)
      (z-pos -200)
      (width 47)
      (height 35)
      (tiles 2196 2188 2189 2196 2188 2189 -2 2188 2196 2188 2189 2196 2188 2189 -2 2188 2196 2188 2189 2196 2188 2189 -2 2188 2196 2188 2189 2196 2188 2189 -2 2188 2196 2188 2189 2196 2188 2189 -2 2188 2196 2188 2189 2196 2188 2189 2188 2179 2195 2196 2179 -3 2195 2196 2179 2195 2196 2179 -3 2195 2196 2179 2195 2196 2179 -3 2195 2196 2179 2195 2196 2179 -3 2195 2196 2179 2195 2196 2179 -3 2195 2196 2179 2195 2196 2179 -3 2195 2188 2196 -2 2188 2189 2196 2189 -2 2188 2196 -2 2188 2189 2196 2189 -2 2188 2196 -2 2188 2189 2196 2189 -2 2188 2196 -2 2188 2189 2196 2189 -2 2188 2196 -2 2188 2189 2196 2189 -2 2188 2196 -2 2188 2189 2196 2189 2197 2180 2181 2197 2187 2181 2180 2187 2197 2180 2181 2197 2187 2181 2180 2187 2197 2180 2181 2197 2187 2181 2180 2187 2197 2180 2181 2197 2187 2181 2180 2187 2197 2180 2181 2197 2187 2181 2180 2187 2197 2180 2181 2197 2187 2181 2180 2196 2188 2189 2196 2188 2189 -2 2188 2196 2188 2189 2196 2188 2189 -2 2188 2196 2188 2189 2196 2188 2189 -2 2188 2196 2188 2189 2196 2188 2189 -2 2188 2196 2188 2189 2196 2188 2189 -2 2188 2196 2188 2189 2196 2188 2189 2188 2179 2195 2196 2179 -3 2195 2196 2179 2195 2196 2179 -3 2195 2196 2179 2195 2196 2179 -3 2195 2196 2179 2195 2196 2179 -3 2195 2196 2179 2195 2196 2179 -3 2195 2196 2179 2195 2196 2179 -3 2195 2188 2196 -2 2188 2189 2196 2189 -2 2188 2196 -2 2188 2189 2196 2189 -2 2188 2196 -2 2188 2189 2196 2189 -2 2188 2196 -2 2188 2189 2196 2189 -2 2188 2196 -2 2188 2189 2196 2189 -2 2188 2196 -2 2188 2189 2196 2189 2197 2180 2181 2197 2187 2181 2180 2187 2197 2180 2181 2197 2187 2181 2180 2187 2197 2180 2181 2197 2187 2181 2180 2187 2197 2180 2181 2197 2187 2181 2180 2187 2197 2180 2181 2197 2187 2181 2180 2187 2197 2180 2181 2197 2187 2181 2180 2196 2188 2189 2196 2188 2189 -2 2188 2196 2188 2189 2196 2188 2189 -2 2188 2196 2188 2189 2196 2188 2189 -2 2188 2196 2188 2189 2196 2188 2189 -2 2188 2196 2188 2189 2196 2188 2189 -2 2188 2196 2188 2189 2196 2188 2189 2188 2179 2195 2196 2179 -3 2195 2196 2179 2195 2196 2179 -3 2195 2196 2179 2195 2196 2179 -3 2195 2196 2179 2195 2196 2179 -3 2195 2196 2179 2195 2196 2179 -3 2195 2196 2179 2195 2196 2179 -3 2195 2188 2196 -2 2188 2189 2196 2189 -2 2188 2196 -2 2188 2189 2196 2189 -2 2188 2196 -2 2188 2189 2196 2189 -2 2188 2196 -2 2188 2189 2196 2189 -2 2188 2196 -2 2188 2189 2196 2189 -2 2188 2196 -2 2188 2189 2196 2189 2197 2180 2181 2197 2187 2181 2180 2187 2197 2180 2181 2197 2187 2181 2180 2187 2197 2180 2181 2197 2187 2181 2180 2187 2197 2180 2181 2197 2187 2181 2180 2187 2197 2180 2181 2197 2187 2181 2180 2187 2197 2180 2181 2197 2187 2181 2180 2196 2188 2189 2196 2188 2189 -2 2188 2196 2188 2189 2196 2188 2189 -2 2188 2196 2188 2189 2196 2188 2189 -2 2188 2196 2188 2189 2196 2188 2189 -2 2188 2196 2188 2189 2196 2188 2189 -2 2188 2196 2188 2189 2196 2188 2189 2188 2179 2195 2196 2179 -3 2195 2196 2179 2195 2196 2179 -3 2195 2196 2179 2195 2196 2179 -3 2195 2196 2179 2195 2196 2179 -3 2195 2196 2179 2195 2196 2179 -3 2195 2196 2179 2195 2196 2179 -3 2195 2188 2196 -2 2188 2189 2196 2189 -2 2188 2196 -2 2188 2189 2196 2189 -2 2188 2196 -2 2188 2189 2196 2189 -2 2188 2196 -2 2188 2189 2196 2189 -2 2188 2196 -2 2188 2189 2196 2189 -2 2188 2196 -2 2188 2189 2196 2189 2197 2180 2181 2197 2187 2181 2180 2187 2197 2180 2181 2197 2187 2181 2180 2187 2197 2180 2181 2197 2187 2181 2180 2187 2197 2180 2181 2197 2187 2181 2180 2187 2197 2180 2181 2197 2187 2181 2180 2187 2197 2180 2181 2197 2187 2181 2180 2196 2188 2189 2196 2188 2189 -2 2188 2196 2188 2189 2196 2188 2189 -2 2188 2196 2188 2189 2196 2188 2189 -2 2188 2196 2188 2189 2196 2188 2189 -2 2188 2196 2188 2189 2196 2188 2189 -2 2188 2196 2188 2189 2196 2188 2189 2188 2179 2195 2196 2179 -3 2195 2196 2179 2195 2196 2179 -3 2195 2196 2179 2195 2196 2179 -3 2195 2196 2179 2195 2196 2179 -3 2195 2196 2179 2195 2196 2179 -3 2195 2196 2179 2195 2196 2179 -3 2195 2188 2196 -2 2188 2189 2196 2189 -2 2188 2196 -2 2188 2189 2196 2189 -2 2188 2196 -2 2188 2189 2196 2189 -2 2188 2196 -2 2188 2189 2196 2189 -2 2188 2196 -2 2188 2189 2196 2189 -2 2188 2196 -2 2188 2189 2196 2189 2197 2180 2181 2197 2187 2181 2180 2187 2197 2180 2181 2197 2187 2181 2180 2187 2197 2180 2181 2197 2187 2181 2180 2187 2197 2180 2181 2197 2187 2181 2180 2187 2197 2180 2181 2197 2187 2181 2180 2187 2197 2180 2181 2197 2187 2181 2180 2196 2188 2189 2196 2188 2189 -2 2188 2196 2188 2189 2196 2188 2189 -2 2188 2196 2188 2189 2196 2188 2189 -2 2188 2196 2188 2189 2196 2188 2189 -2 2188 2196 2188 2189 2196 2188 2189 -2 2188 2196 2188 2189 2196 2188 2189 2188 2179 2195 2196 2179 -3 2195 2196 2179 2195 2196 2179 -3 2195 2196 2179 2195 2196 2179 -3 2195 2196 2179 2195 2196 2179 -3 2195 2196 2179 2195 2196 2179 -3 2195 2196 2179 2195 2196 2179 -3 2195 2188 2196 -2 2188 2189 2196 2189 -2 2188 2196 -2 2188 2189 2196 2189 -2 2188 2196 -2 2188 2189 2196 2189 -2 2188 2196 -2 2188 2189 2196 2189 -2 2188 2196 -2 2188 2189 2196 2189 -2 2188 2196 -2 2188 2189 2196 2189 2197 2180 2181 2197 2187 2181 2180 2187 2197 2180 2181 2197 2187 2181 2180 2187 2197 2180 2181 2197 2187 2181 2180 2187 2197 2180 2181 2197 2187 2181 2180 2187 2197 2180 2181 2197 2187 2181 2180 2187 2197 2180 2181 2197 2187 2181 2180 2196 2188 2189 2196 2188 2189 -2 2188 2196 2188 2189 2196 2188 2189 -2 2188 2196 2188 2189 2196 2188 2189 -2 2188 2196 2188 2189 2196 2188 2189 -2 2188 2196 2188 2189 2196 2188 2189 -2 2188 2196 2188 2189 2196 2188 2189 2188 2179 2195 2196 2179 -3 2195 2196 2179 2195 2196 2179 -3 2195 2196 2179 2195 2196 2179 -3 2195 2196 2179 2195 2196 2179 -3 2195 2196 2179 2195 2196 2179 -3 2195 2196 2179 2195 2196 2179 -3 2195 2188 2196 -2 2188 2189 2196 2189 -2 2188 2196 -2 2188 2189 2196 2189 -2 2188 2196 -2 2188 2189 2196 2189 -2 2188 2196 -2 2188 2189 2196 2189 -2 2188 2196 -2 2188 2189 2196 2189 -2 2188 2196 -2 2188 2189 2196 2189 2197 2180 2181 2197 2187 2181 2180 2187 2197 2180 2181 2197 2187 2181 2180 2187 2197 2180 2181 2197 2187 2181 2180 2187 2197 2180 2181 2197 2187 2181 2180 2187 2197 2180 2181 2197 2187 2181 2180 2187 2197 2180 2181 2197 2187 2181 2180 2196 2188 2189 2196 2188 2189 -2 2188 2196 2188 2189 2196 2188 2189 -2 2188 2196 2188 2189 2196 2188 2189 -2 2188 2196 2188 2189 2196 2188 2189 -2 2188 2196 2188 2189 2196 2188 2189 -2 2188 2196 2188 2189 2196 2188 2189 2188 2179 2195 2196 2179 -3 2195 2196 2179 2195 2196 2179 -3 2195 2196 2179 2195 2196 2179 -3 2195 2196 2179 2195 2196 2179 -3 2195 2196 2179 2195 2196 2179 -3 2195 2196 2179 2195 2196 2179 -3 2195 2188 2196 -2 2188 2189 2196 2189 -2 2188 2196 -2 2188 2189 2196 2189 -2 2188 2196 -2 2188 2189 2196 2189 -2 2188 2196 -2 2188 2189 2196 2189 -2 2188 2196 -2 2188 2189 2196 2189 -2 2188 2196 -2 2188 2189 2196 2189 2197 2180 2181 2197 2187 2181 2180 2187 2197 2180 2181 2197 2187 2181 2180 2187 2197 2180 2181 2197 2187 2181 2180 2187 2197 2180 2181 2197 2187 2181 2180 2187 2197 2180 2181 2197 2187 2181 2180 2187 2197 2180 2181 2197 2187 2181 2180 2197 2180 2181 2197 2187 2181 2180 2187 2197 2180 2181 2197 2187 2181 2180 2187 2197 2180 2181 2197 2187 2181 2180 2187 2197 2180 2181 2197 2187 2181 2180 2187 2197 2180 2181 2197 2187 2181 2180 2187 2197 2180 2181 2197 2187 2181 2180 2196 2188 2189 2196 2188 2189 -2 2188 2196 2188 2189 2196 2188 2189 -2 2188 2196 2188 2189 2196 2188 2189 -2 2188 2196 2188 2189 2196 2188 2189 -2 2188 2196 2188 2189 2196 2188 2189 -2 2188 2196 2188 2189 2196 2188 2189 2188 2179 2195 2196 2179 -3 2195 2196 2179 2195 2196 2179 -3 2195 2196 2179 2195 2196 2179 -3 2195 2196 2179 2195 2196 2179 -3 2195 2196 2179 2195 2196 2179 -3 2195 2196 2179 2195 2196 2179 -3 2195)
    )
    (torch
      (z-pos 0)
      (x 320)
      (y 608)
    )
    (torch
      (sprite "/images/objects/torch/torch2.sprite")
      (z-pos 0)
      (x 1152)
      (y 608)
    )
    (yeti
      (z-pos 50)
      (dead-script "Tux.trigger_sequence(\"fireworks\");")
      (x 192)
      (y 608)
    )
    (yeti_stalactite
      (z-pos -1)
      (x 896)
      (y 512)
    )
    (yeti_stalactite
      (z-pos -1)
      (x 864)
      (y 512)
    )
    (yeti_stalactite
      (z-pos -1)
      (x 832)
      (y 512)
    )
    (yeti_stalactite
      (z-pos -1)
      (x 800)
      (y 512)
    )
    (yeti_stalactite
      (z-pos -1)
      (x 768)
      (y 512)
    )
    (yeti_stalactite
      (z-pos -1)
      (x 736)
      (y 512)
    )
    (yeti_stalactite
      (z-pos -1)
      (x 704)
      (y 512)
    )
    (yeti_stalactite
      (z-pos -1)
      (x 672)
      (y 512)
    )
    (yeti_stalactite
      (z-pos -1)
      (x 640)
      (y 512)
    )
    (yeti_stalactite
      (z-pos -1)
      (x 608)
      (y 512)
    )
    (yeti_stalactite
      (z-pos -1)
      (x 576)
      (y 512)
    )
    (yeti_stalactite
      (z-pos -1)
      (x 544)
      (y 512)
    )
    (yeti_stalactite
      (z-pos -1)
      (x 512)
      (y 512)
    )
    (yeti_stalactite
      (z-pos -1)
      (x 480)
      (y 512)
    )
    (yeti_stalactite
      (z-pos -1)
      (x 448)
      (y 512)
    )
    (yeti_stalactite
      (z-pos -1)
      (x 416)
      (y 512)
    )
    (yeti_stalactite
      (z-pos -1)
      (x 384)
      (y 512)
    )
    (yeti_stalactite
      (z-pos -1)
      (x 352)
      (y 512)
    )
    (yeti_stalactite
      (z-pos -1)
      (x 320)
      (y 512)
    )
    (yeti_stalactite
      (z-pos -1)
      (x 288)
      (y 512)
    )
    (yeti_stalactite
      (z-pos -1)
      (x 256)
      (y 512)
    )
    (yeti_stalactite
      (z-pos -1)
      (x 192)
      (y 512)
    )
    (yeti_stalactite
      (z-pos -1)
      (x 224)
      (y 512)
    )
    (yeti_stalactite
      (z-pos -1)
      (x 160)
      (y 512)
    )
    (yeti_stalactite
      (z-pos -1)
      (x 128)
      (y 512)
    )
    (yeti_stalactite
      (z-pos -1)
      (x 96)
      (y 512)
    )
    (yeti_stalactite
      (z-pos -1)
      (x 32)
      (y 512)
    )
    (yeti_stalactite
      (z-pos -1)
      (x 0)
      (y 512)
    )
    (yeti_stalactite
      (z-pos -1)
      (x 64)
      (y 512)
    )
    (yeti_stalactite
      (z-pos -1)
      (x 928)
      (y 512)
    )
    (yeti_stalactite
      (z-pos -1)
      (x 960)
      (y 512)
    )
    (yeti_stalactite
      (z-pos -1)
      (x 992)
      (y 512)
    )
    (yeti_stalactite
      (z-pos -1)
      (x 1024)
      (y 512)
    )
    (yeti_stalactite
      (z-pos -1)
      (x 1056)
      (y 512)
    )
    (yeti_stalactite
      (z-pos -1)
      (x 1088)
      (y 512)
    )
    (yeti_stalactite
      (z-pos -1)
      (x 1120)
      (y 512)
    )
    (yeti_stalactite
      (z-pos -1)
      (x 1152)
      (y 512)
    )
    (yeti_stalactite
      (z-pos -1)
      (x 1184)
      (y 512)
    )
    (yeti_stalactite
      (z-pos -1)
      (x 1216)
      (y 512)
    )
    (yeti_stalactite
      (z-pos -1)
      (x 1248)
      (y 512)
    )
    (yeti_stalactite
      (z-pos -1)
      (x 1280)
      (y 512)
    )
    (yeti_stalactite
      (z-pos -1)
      (x 1312)
      (y 512)
    )
    (yeti_stalactite
      (z-pos -1)
      (x 1344)
      (y 512)
    )
    (yeti_stalactite
      (z-pos -1)
      (x 1376)
      (y 512)
    )
    (yeti_stalactite
      (z-pos -1)
      (x 1408)
      (y 512)
    )
    (yeti_stalactite
      (z-pos -1)
      (x 1440)
      (y 512)
    )
    (yeti_stalactite
      (z-pos -1)
      (x 1472)
      (y 512)
    )
  )
)
