(supertux-level
  (version 3)
  (name (_ "Rooted Forest"))
  (author "SuperTux Player")
  (license "CC-BY-SA 4.0 International")
  (allow-item-pocket "on")
  (icon "")
  (icon-locked "")
  (sector
    (name "main")
    (ambient-light
      (color 1 1 1)
    )
    (level
      (z-pos 50)
      (level "climbing_vines.stl")
      (x 23)
      (y 17)
    )
    (level
      (z-pos 50)
      (level "welcoming_forest.stl")
      (x 19)
      (y 16)
    )
    (level
      (z-pos 50)
      (level "to_sky.stl")
      (x 28)
      (y 13)
    )
    (level
      (z-pos 50)
      (x 34)
      (y 10)
    )
    (level
      (z-pos 50)
      (x 40)
      (y 10)
    )
    (level
      (z-pos 50)
      (x 42)
      (y 5)
    )
    (level
      (z-pos 50)
      (x 51)
      (y 6)
    )
    (level
      (z-pos 50)
      (x 58)
      (y 10)
    )
    (level
      (z-pos 50)
      (x 61)
      (y 11)
    )
    (level
      (z-pos 50)
      (x 65)
      (y 8)
    )
    (level
      (z-pos 50)
      (x 60)
      (y 3)
    )
    (level
      (z-pos 50)
      (x 56)
      (y 2)
    )
    (level
      (z-pos 50)
      (x 28)
      (y 23)
    )
    (level
      (z-pos 50)
      (x 33)
      (y 26)
    )
    (level
      (z-pos 50)
      (x 38)
      (y 27)
    )
    (level
      (z-pos 50)
      (x 49)
      (y 29)
    )
    (level
      (z-pos 50)
      (x 54)
      (y 24)
    )
    (level
      (z-pos 50)
      (x 60)
      (y 21)
    )
    (level
      (z-pos 50)
      (x 64)
      (y 26)
    )
    (level
      (z-pos 50)
      (x 60)
      (y 31)
    )
    (level
      (z-pos 50)
      (x 53)
      (y 32)
    )
    (level
      (z-pos 50)
      (x 58)
      (y 32)
    )
    (level
      (z-pos 50)
      (x 29)
      (y 17)
    )
    (level
      (z-pos 50)
      (x 37)
      (y 17)
    )
    (level
      (z-pos 50)
      (x 43)
      (y 15)
    )
    (level
      (z-pos 50)
      (x 53)
      (y 17)
    )
    (level
      (z-pos 50)
      (x 58)
      (y 17)
    )
    (music
      (name "Music_Object")
      (file "/music/forest/new_forest_map.music")
    )
    (teleporter
      (z-pos 50)
      (worldmap "/levels/world1/worldmap.stwm")
      (sector "main")
      (spawnpoint "back")
      (message (_ "Go to Icy Island?"))
      (x 14)
      (y 16)
    )
    (tilemap
      (solid #f)
      (z-pos -100)
      (name "Water_Tiles")
      (width 100)
      (height 35)
      (tiles -3500 1)
    )
    (tilemap
      (solid #t)
      (z-pos 0)
      (name "Main_Tiles")
      (width 100)
      (height 35)
      (tiles -151 0 257 -8 258 259 -88 0 257 258 266 -8 261 267 258 259 -83 0 257 -2 258 266 -12 261 267 258 259 -71 0 257 -9 258 266 -17 261 267 259 -68 0 257 258 266 -28 261 262 -66 0 257 258 266 -30 261 267 259 -64 0 257 266 -33 261 262 -62 0 257 258 266 -34 261 262 -60 0 257 258 266 -36 261 262 -58 0 257 258 266 -37 261 269 265 -57 0 257 266 -39 261 262 -55 0 257 -2 258 266 -39 261 269 265 -52 0 257 -2 258 266 -41 261 269 265 -51 0 257 258 266 -42 261 269 264 265 -51 0 257 266 -43 261 269 265 -53 0 260 -44 261 262 -54 0 263 268 -43 261 262 -55 0 263 264 268 -41 261 262 -57 0 263 264 268 -39 261 267 258 259 -57 0 263 268 -40 261 267 259 -57 0 263 268 -40 261 267 259 -57 0 263 264 268 -39 261 267 259 -58 0 263 268 -39 261 267 259 -58 0 263 268 -39 261 262 -59 0 263 268 -38 261 262 -60 0 263 264 268 -36 261 262 -62 0 263 264 268 -34 261 262 -64 0 263 -2 264 268 -31 261 262 -67 0 263 -2 264 268 -28 261 262 -70 0 263 -5 264 268 -20 261 269 264 265 -76 0 263 -4 264 268 -13 261 269 264 265 -83 0 263 264 268 -9 261 269 264 265 -87 0 263 -9 264 265 -139 0)
    )
    (tilemap
      (solid #t)
      (z-pos 1)
      (width 100)
      (height 35)
      (tiles -56 0 540 -79 0 540 -9 0 536 -16 0 536 -2 0 540 -66 0 536 -6 0 536 -12 0 10 -5 20 11 -83 0 540 -7 0 10 20 15 -5 0 14 20 11 -89 0 21 -9 0 14 20 11 -3 0 536 -60 0 536 -2 0 540 -7 0 10 -5 20 11 -5 0 21 -11 0 14 11 -60 0 540 -13 0 21 -5 0 14 -5 20 17 -12 0 21 -69 0 10 -4 20 15 -11 0 21 -12 0 14 11 -58 0 536 -9 0 21 -16 0 21 -13 0 21 -3 0 536 -48 0 536 -15 0 21 -16 0 12 -6 20 11 -5 0 10 15 -56 0 540 -5 0 10 -5 20 16 -5 20 13 -10 20 15 -6 0 21 -5 0 21 -4 0 540 -58 0 21 -11 0 21 -17 0 14 -5 20 15 -51 0 536 -11 0 21 -11 0 21 -72 0 540 -9 0 10 -4 20 16 -11 20 15 -2 0 10 -5 20 11 -3 0 543 -14 0 536 -54 0 21 -19 0 21 -5 0 21 -61 0 536 -11 0 21 -19 0 21 -5 0 21 -4 0 356 -59 0 58 59 -7 20 17 -19 0 21 -5 0 21 544 -11 0 540 -60 0 12 -19 20 15 -5 0 21 -2 0 10 -6 20 23 -63 0 21 -25 0 21 -2 0 21 -13 0 536 -45 0 536 -3 0 540 -6 0 21 -25 0 21 0 544 21 -4 0 542 -64 0 542 21 -25 0 21 -2 0 21 -3 0 10 -3 20 11 -58 0 536 -3 0 14 -4 20 13 -9 20 11 544 -9 0 14 -2 20 15 -3 0 21 -3 0 21 -8 0 536 -55 0 542 -2 0 21 -9 0 21 542 -12 0 542 -2 0 542 21 -3 0 14 20 11 -65 0 21 -9 0 21 0 544 -4 0 -2 544 -7 0 10 20 15 -5 0 21 -65 0 21 542 -8 0 12 -10 20 11 -4 0 21 -7 0 14 20 11 -5 0 540 -47 0 540 -9 0 14 -4 20 11 -4 0 21 -10 0 21 0 10 -2 20 15 -9 0 21 -65 0 537 538 539 21 -4 0 21 -10 0 21 0 21 545 -11 0 21 -59 0 -2 536 -7 0 14 -4 20 17 -10 0 12 20 15 546 545 -10 0 21 -70 0 537 538 539 21 -10 0 21 -2 0 545 546 -9 0 10 15 -73 0 14 -10 20 17 -2 0 546 -8 0 10 20 15 -3 0 536 -60 0 540 -20 0 21 -11 0 21 -60 0 540 -26 0 14 -2 20 11 -6 0 10 20 15 -70 0 536 -3 0 540 -3 0 536 -11 0 14 -6 20 15 -5 0 540 -234 0)
    )
    (tilemap
      (solid #f)
      (z-pos 2)
      (width 100)
      (height 35)
      (tiles -51 0 328 329 -98 0 330 331 -95 0 328 329 0 332 333 -93 0 291 292 330 331 -85 0 291 292 328 329 -7 0 293 294 332 333 -2 0 541 0 537 538 539 -78 0 293 294 330 331 -7 0 295 296 -4 0 328 329 328 329 328 329 537 538 539 -71 0 328 329 0 295 296 332 333 -4 0 291 292 -7 0 330 331 330 331 330 331 -2 0 328 329 -68 0 291 292 330 331 -8 0 542 293 294 542 291 292 543 0 542 0 332 333 332 333 332 333 541 0 330 331 -68 0 293 294 332 333 -5 0 542 537 538 539 295 296 0 293 294 0 542 544 -6 0 537 539 -2 332 333 0 537 539 -65 0 295 296 -9 0 542 -4 0 295 296 542 0 541 -12 0 541 -61 0 291 292 -25 0 542 291 292 543 544 543 -4 0 537 539 -61 0 293 294 -15 0 542 -7 0 -2 542 543 293 294 0 356 544 -61 0 328 329 -4 0 295 296 -4 0 537 -2 538 539 -2 0 537 538 539 0 328 329 537 539 0 537 539 537 538 539 537 539 295 296 291 292 0 544 291 292 -56 0 291 292 330 331 291 292 -18 0 330 331 -7 0 291 292 365 366 367 293 294 291 292 293 294 -56 0 293 294 332 333 293 294 0 328 329 545 0 545 0 545 0 545 328 329 328 329 328 329 -2 0 332 333 0 291 292 291 292 -2 0 293 294 368 369 370 295 296 293 294 295 296 -56 0 295 296 -2 0 295 296 0 330 331 546 545 546 545 546 545 546 330 331 330 331 330 331 537 -2 538 539 0 293 294 293 294 -2 0 295 296 371 372 373 -2 0 295 296 544 -64 0 332 333 541 546 0 546 541 546 0 332 333 332 333 332 333 0 537 539 -2 0 295 296 295 296 -3 0 356 374 375 376 -2 0 356 543 -60 0 545 0 291 292 -27 0 543 0 377 378 379 -64 0 546 0 293 294 0 328 329 0 328 329 328 329 545 0 328 329 545 0 545 0 545 537 -3 538 539 -6 0 356 0 356 545 0 545 -4 0 291 292 -58 0 295 296 0 330 331 545 330 331 330 331 546 545 330 331 546 545 546 545 546 545 291 292 291 292 -5 0 356 -2 0 545 546 545 546 -4 0 293 294 -61 0 332 333 546 332 333 332 333 0 546 332 333 544 546 0 546 0 546 293 294 293 294 291 292 -4 0 543 0 546 545 546 -5 0 295 296 291 292 -76 0 295 296 295 296 293 294 -6 0 545 546 -4 0 543 0 356 542 293 294 -61 0 -2 544 -2 0 291 292 537 539 291 292 537 539 -7 0 295 296 -3 545 291 292 0 546 -9 0 295 296 -62 0 544 0 541 293 294 543 544 293 294 291 292 -9 0 -3 546 293 294 -6 0 541 -4 0 542 0 545 -64 0 295 296 544 541 295 296 293 294 -12 0 295 296 -13 0 546 -70 0 295 296 0 291 292 537 539 291 292 537 539 291 292 -6 0 541 -2 0 291 292 -3 0 545 0 545 -70 0 537 539 0 293 294 328 329 293 294 328 329 293 294 -6 0 291 292 0 293 294 541 291 292 546 0 546 -73 0 295 296 330 331 295 296 330 331 295 296 -6 0 293 294 0 295 296 0 293 294 -2 0 545 -73 0 537 539 332 333 537 539 332 333 537 539 -6 0 295 296 -2 0 291 292 295 296 -2 0 546 -90 0 541 291 292 293 294 -83 0 537 -3 538 539 -8 0 293 294 295 296 -93 0 537 538 539 295 296 -341 0)
    )
    (tilemap
      (solid #f)
      (z-pos 3)
      (width 100)
      (height 35)
      (tiles -349 0 328 329 -98 0 330 331 -98 0 332 333 -102 0 328 329 328 329 -96 0 330 331 330 331 -2 0 328 329 328 329 -90 0 332 333 332 333 -2 0 330 331 330 331 -96 0 332 333 332 333 -492 0 291 292 -98 0 293 294 -88 0 291 292 291 292 -6 0 295 296 -88 0 293 294 293 294 -96 0 295 296 295 296 -191 0 291 292 291 292 -96 0 293 294 293 294 -96 0 295 296 295 296 -190 0 291 292 -98 0 293 294 -98 0 295 296 -21 0 291 292 -4 0 545 -93 0 293 294 -4 0 546 -90 0 291 292 0 295 296 -6 0 545 -84 0 -2 545 -2 0 293 294 -9 0 546 -84 0 -2 546 0 545 295 296 -97 0 546 -346 0)
    )
    (tilemap
      (solid #f)
      (z-pos 100)
      (width 100)
      (height 35)
      (tiles -154 0 328 329 -98 0 330 331 0 328 329 -94 0 545 332 333 0 330 331 -2 0 328 329 -90 0 546 -3 0 332 333 -2 0 330 331 -77 0 291 292 -19 0 332 333 545 -72 0 291 292 -2 0 293 294 -21 0 546 -72 0 293 294 -2 0 295 296 -94 0 295 296 -93 0 291 292 -4 0 291 292 -4 0 291 292 328 329 -82 0 291 292 293 294 -2 0 291 292 293 294 -4 0 293 294 330 331 0 -2 545 -79 0 293 294 295 296 -2 0 293 294 295 296 -4 0 295 296 332 333 0 -2 546 -79 0 295 296 -4 0 295 296 -90 0 545 0 545 0 545 -95 0 546 0 546 0 546 -185 0 -2 545 0 545 -96 0 -2 546 0 546 -11 0 545 -3 0 545 0 545 -16 0 545 0 545 0 291 292 -71 0 546 -3 0 546 0 546 -16 0 546 0 546 0 293 294 -98 0 295 296 -96 0 291 292 -98 0 293 294 -98 0 295 296 291 292 -95 0 291 292 0 293 294 291 292 -93 0 293 294 0 295 296 293 294 -91 0 545 0 295 296 -3 0 295 296 -91 0 546 -96 0 545 -99 0 546 -110 0 545 -99 0 546 -437 0)
    )
    (tilemap
      (solid #f)
      (z-pos 4)
      (width 100)
      (height 35)
      (tiles -860 0 328 329 -98 0 330 331 -98 0 332 333 -684 0 291 292 -98 0 293 294 -98 0 295 296 -193 0 291 292 291 292 -96 0 293 294 293 294 -96 0 295 296 295 296 -1155 0)
    )
    (tilemap
      (solid #f)
      (z-pos 5)
      (width 100)
      (height 35)
      (tiles -1847 0 291 292 -98 0 293 294 -98 0 295 296 -1451 0)
    )
    (worldmap-spawnpoint
      (z-pos 50)
      (name "main")
      (x 15)
      (y 16)
    )
  )
  (tileset "images/ice_world.strf")
)
